NONE	Orthogroup	Aalb	Anoste	Asub	Cpal	Ppap	Wsmi	Total
NONE	OG0000000	70	0	20	14	16	27	147
NONE	OG0000001	45	0	31	22	13	14	125
NONE	OG0000002	25	0	32	15	0	45	117
NONE	OG0000003	52	0	16	1	17	23	109
NONE	OG0000004	47	0	18	3	10	19	97
NONE	OG0000005	29	0	21	27	3	15	95
NONE	OG0000006	26	0	14	4	16	24	84
NONE	OG0000007	6	57	6	3	2	9	83
NONE	OG0000008	0	0	0	81	0	0	81
NONE	OG0000009	50	0	9	1	0	17	77
NONE	OG0000010	28	0	29	7	0	10	74
NONE	OG0000011	22	0	25	14	1	9	71
NONE	OG0000012	12	0	14	15	22	7	70
NONE	OG0000013	39	0	11	1	8	10	69
NONE	OG0000014	13	0	19	22	2	13	69
NONE	OG0000015	15	0	8	4	32	8	67
NONE	OG0000016	27	0	5	9	0	20	61
NONE	OG0000017	11	0	12	9	12	16	60
NONE	OG0000018	32	0	12	8	0	7	59
NONE	OG0000019	42	0	4	5	1	7	59
NONE	OG0000020	14	2	10	20	6	5	57
NONE	OG0000021	0	0	0	0	0	57	57
NONE	OG0000022	16	1	11	7	13	6	54
NONE	OG0000023	0	0	0	54	0	0	54
NONE	OG0000024	48	0	0	1	0	4	53
NONE	OG0000025	10	3	10	14	11	5	53
NONE	OG0000026	20	0	8	16	0	8	52
NONE	OG0000027	11	9	9	11	1	11	52
NONE	OG0000028	10	0	33	1	0	7	51
NONE	OG0000029	19	0	11	10	1	10	51
NONE	OG0000030	13	5	8	17	0	7	50
NONE	OG0000031	13	0	6	22	2	7	50
NONE	OG0000032	14	0	9	5	0	21	49
NONE	OG0000033	0	0	0	0	49	0	49
NONE	OG0000034	14	0	16	10	2	6	48
NONE	OG0000035	16	0	1	1	1	29	48
NONE	OG0000036	9	5	10	10	5	9	48
NONE	OG0000037	10	0	15	0	0	22	47
NONE	OG0000038	4	15	4	18	1	5	47
NONE	OG0000039	2	0	0	42	1	2	47
NONE	OG0000040	18	0	21	4	0	3	46
NONE	OG0000041	18	0	7	5	0	16	46
NONE	OG0000042	19	0	15	7	0	4	45
NONE	OG0000043	8	1	15	9	4	8	45
NONE	OG0000044	7	0	23	14	0	1	45
NONE	OG0000045	9	4	9	10	1	12	45
NONE	OG0000046	3	0	33	0	0	8	44
NONE	OG0000047	10	1	0	30	0	2	43
NONE	OG0000048	7	3	12	8	4	8	42
NONE	OG0000049	9	0	3	4	24	2	42
NONE	OG0000050	0	0	0	0	41	0	41
NONE	OG0000051	7	3	7	10	8	5	40
NONE	OG0000052	19	0	3	1	0	16	39
NONE	OG0000053	21	0	17	0	1	0	39
NONE	OG0000054	13	0	9	8	0	8	38
NONE	OG0000055	24	0	14	0	0	0	38
NONE	OG0000056	18	0	6	9	0	5	38
NONE	OG0000057	7	2	10	7	2	10	38
NONE	OG0000058	8	3	11	7	1	8	38
NONE	OG0000059	7	0	5	15	0	10	37
NONE	OG0000060	26	0	1	8	0	1	36
NONE	OG0000061	24	0	2	8	0	2	36
NONE	OG0000062	9	0	2	0	0	25	36
NONE	OG0000063	8	2	7	10	2	7	36
NONE	OG0000064	5	1	20	5	2	3	36
NONE	OG0000065	7	3	7	5	8	6	36
NONE	OG0000066	10	0	15	1	1	8	35
NONE	OG0000067	3	0	22	0	0	10	35
NONE	OG0000068	11	0	7	7	1	9	35
NONE	OG0000069	5	1	4	3	19	3	35
NONE	OG0000070	20	0	7	1	0	6	34
NONE	OG0000071	9	0	12	10	1	2	34
NONE	OG0000072	4	10	5	8	1	6	34
NONE	OG0000073	7	5	8	7	1	6	34
NONE	OG0000074	5	0	26	0	0	3	34
NONE	OG0000075	3	0	6	1	24	0	34
NONE	OG0000076	7	2	7	7	3	7	33
NONE	OG0000077	10	1	7	11	1	3	33
NONE	OG0000078	0	0	0	33	0	0	33
NONE	OG0000079	18	0	3	0	0	11	32
NONE	OG0000080	7	5	5	10	0	5	32
NONE	OG0000081	11	0	6	11	2	2	32
NONE	OG0000082	6	0	1	18	1	6	32
NONE	OG0000083	0	0	0	0	32	0	32
NONE	OG0000084	20	0	8	2	0	1	31
NONE	OG0000085	5	4	6	7	1	8	31
NONE	OG0000086	12	0	11	1	1	6	31
NONE	OG0000087	6	0	4	3	10	8	31
NONE	OG0000088	31	0	0	0	0	0	31
NONE	OG0000089	8	0	8	10	1	4	31
NONE	OG0000090	0	0	0	31	0	0	31
NONE	OG0000091	0	0	0	0	31	0	31
NONE	OG0000092	27	0	1	1	0	1	30
NONE	OG0000093	8	0	5	0	2	15	30
NONE	OG0000094	23	0	7	0	0	0	30
NONE	OG0000095	12	0	7	3	0	7	29
NONE	OG0000096	12	0	2	0	0	15	29
NONE	OG0000097	7	4	5	8	1	4	29
NONE	OG0000098	10	0	0	7	4	8	29
NONE	OG0000099	7	1	7	4	7	3	29
NONE	OG0000100	21	0	0	5	0	3	29
NONE	OG0000101	7	0	5	9	0	8	29
NONE	OG0000102	5	4	5	6	3	6	29
NONE	OG0000103	4	0	17	2	0	6	29
NONE	OG0000104	6	3	8	3	0	9	29
NONE	OG0000105	14	0	10	0	0	4	28
NONE	OG0000106	19	0	9	0	0	0	28
NONE	OG0000107	7	0	8	9	0	4	28
NONE	OG0000108	3	1	7	6	8	3	28
NONE	OG0000109	6	2	10	2	3	5	28
NONE	OG0000110	19	0	2	1	0	5	27
NONE	OG0000111	27	0	0	0	0	0	27
NONE	OG0000112	3	0	2	3	0	19	27
NONE	OG0000113	11	0	7	4	0	5	27
NONE	OG0000114	7	2	7	3	3	5	27
NONE	OG0000115	13	0	8	0	0	6	27
NONE	OG0000116	11	0	6	8	0	2	27
NONE	OG0000117	7	3	7	5	1	4	27
NONE	OG0000118	27	0	0	0	0	0	27
NONE	OG0000119	2	0	22	1	0	2	27
NONE	OG0000120	9	1	6	5	2	4	27
NONE	OG0000121	2	2	2	7	12	2	27
NONE	OG0000122	4	0	10	9	0	4	27
NONE	OG0000123	0	0	0	0	27	0	27
NONE	OG0000124	0	0	0	0	0	27	27
NONE	OG0000125	0	0	0	0	0	27	27
NONE	OG0000126	14	0	4	8	0	0	26
NONE	OG0000127	5	0	9	4	0	8	26
NONE	OG0000128	3	1	15	3	1	3	26
NONE	OG0000129	2	0	24	0	0	0	26
NONE	OG0000130	7	1	9	5	1	3	26
NONE	OG0000131	5	2	3	11	2	3	26
NONE	OG0000132	5	1	5	10	0	5	26
NONE	OG0000133	0	0	0	25	1	0	26
NONE	OG0000134	0	0	0	26	0	0	26
NONE	OG0000135	16	0	2	7	0	0	25
NONE	OG0000136	7	0	9	0	1	8	25
NONE	OG0000137	25	0	0	0	0	0	25
NONE	OG0000138	4	2	10	5	1	3	25
NONE	OG0000139	6	2	10	0	5	2	25
NONE	OG0000140	4	0	5	13	0	3	25
NONE	OG0000141	6	1	6	7	0	5	25
NONE	OG0000142	4	0	20	0	0	1	25
NONE	OG0000143	3	2	3	3	10	4	25
NONE	OG0000144	6	2	5	6	0	6	25
NONE	OG0000145	0	0	25	0	0	0	25
NONE	OG0000146	2	0	4	0	7	11	24
NONE	OG0000147	10	0	4	5	0	5	24
NONE	OG0000148	14	0	4	0	0	6	24
NONE	OG0000149	9	0	7	1	0	7	24
NONE	OG0000150	1	0	3	15	0	5	24
NONE	OG0000151	3	3	3	5	3	7	24
NONE	OG0000152	24	0	0	0	0	0	24
NONE	OG0000153	8	1	7	1	1	6	24
NONE	OG0000154	5	1	5	11	0	2	24
NONE	OG0000155	3	0	20	0	0	1	24
NONE	OG0000156	4	4	7	4	1	4	24
NONE	OG0000157	5	3	4	4	4	4	24
NONE	OG0000158	3	2	3	8	0	8	24
NONE	OG0000159	0	0	0	24	0	0	24
NONE	OG0000160	12	0	4	6	0	1	23
NONE	OG0000161	19	0	4	0	0	0	23
NONE	OG0000162	4	0	18	1	0	0	23
NONE	OG0000163	4	0	0	0	0	19	23
NONE	OG0000164	5	2	4	6	2	4	23
NONE	OG0000165	4	3	3	3	5	5	23
NONE	OG0000166	8	0	7	0	0	8	23
NONE	OG0000167	10	0	5	6	0	2	23
NONE	OG0000168	17	0	4	2	0	0	23
NONE	OG0000169	4	0	12	1	0	6	23
NONE	OG0000170	10	0	2	7	4	0	23
NONE	OG0000171	10	0	1	12	0	0	23
NONE	OG0000172	7	1	1	9	1	4	23
NONE	OG0000173	3	3	3	3	4	7	23
NONE	OG0000174	1	0	2	0	0	20	23
NONE	OG0000175	5	1	4	4	5	4	23
NONE	OG0000176	5	2	5	4	5	2	23
NONE	OG0000177	8	0	9	4	0	1	22
NONE	OG0000178	19	0	2	0	1	0	22
NONE	OG0000179	3	6	7	0	2	4	22
NONE	OG0000180	1	0	1	18	1	1	22
NONE	OG0000181	5	0	3	0	10	4	22
NONE	OG0000182	3	0	18	0	0	1	22
NONE	OG0000183	8	0	3	8	0	3	22
NONE	OG0000184	5	2	5	3	3	4	22
NONE	OG0000185	4	3	3	8	1	3	22
NONE	OG0000186	7	0	7	5	0	3	22
NONE	OG0000187	6	2	9	2	1	2	22
NONE	OG0000188	2	0	1	2	9	8	22
NONE	OG0000189	3	7	4	3	1	4	22
NONE	OG0000190	9	1	4	4	1	3	22
NONE	OG0000191	5	0	4	5	3	5	22
NONE	OG0000192	1	0	21	0	0	0	22
NONE	OG0000193	0	0	22	0	0	0	22
NONE	OG0000194	0	0	0	0	22	0	22
NONE	OG0000195	7	0	9	0	0	5	21
NONE	OG0000196	10	0	3	0	0	8	21
NONE	OG0000197	17	0	1	2	0	1	21
NONE	OG0000198	3	4	3	3	5	3	21
NONE	OG0000199	8	0	13	0	0	0	21
NONE	OG0000200	18	0	1	0	0	2	21
NONE	OG0000201	7	0	4	1	9	0	21
NONE	OG0000202	3	3	4	3	3	5	21
NONE	OG0000203	3	2	4	5	4	3	21
NONE	OG0000204	9	0	5	5	1	1	21
NONE	OG0000205	3	2	3	4	6	3	21
NONE	OG0000206	5	1	6	5	0	4	21
NONE	OG0000207	3	7	3	4	2	2	21
NONE	OG0000208	6	1	5	5	1	3	21
NONE	OG0000209	0	0	21	0	0	0	21
NONE	OG0000210	0	0	0	19	0	2	21
NONE	OG0000211	0	0	0	0	21	0	21
NONE	OG0000212	20	0	0	0	0	0	20
NONE	OG0000213	9	0	5	3	0	3	20
NONE	OG0000214	15	0	5	0	0	0	20
NONE	OG0000215	3	3	3	4	4	3	20
NONE	OG0000216	3	0	1	0	0	16	20
NONE	OG0000217	8	0	5	1	0	6	20
NONE	OG0000218	18	0	1	0	0	1	20
NONE	OG0000219	12	0	2	0	0	6	20
NONE	OG0000220	5	0	14	1	0	0	20
NONE	OG0000221	2	2	4	8	1	3	20
NONE	OG0000222	16	0	3	0	0	1	20
NONE	OG0000223	20	0	0	0	0	0	20
NONE	OG0000224	19	0	1	0	0	0	20
NONE	OG0000225	8	0	4	0	0	8	20
NONE	OG0000226	20	0	0	0	0	0	20
NONE	OG0000227	6	0	7	0	0	7	20
NONE	OG0000228	3	0	9	1	0	7	20
NONE	OG0000229	6	1	4	3	0	6	20
NONE	OG0000230	6	1	6	4	0	3	20
NONE	OG0000231	8	1	8	1	1	1	20
NONE	OG0000232	0	0	1	0	19	0	20
NONE	OG0000233	0	0	0	20	0	0	20
NONE	OG0000234	0	0	0	0	20	0	20
NONE	OG0000235	0	0	0	0	20	0	20
NONE	OG0000236	5	0	4	6	1	3	19
NONE	OG0000237	12	0	7	0	0	0	19
NONE	OG0000238	4	1	6	6	0	2	19
NONE	OG0000239	4	0	5	3	0	7	19
NONE	OG0000240	5	0	11	2	0	1	19
NONE	OG0000241	5	0	2	6	0	6	19
NONE	OG0000242	7	0	5	4	0	3	19
NONE	OG0000243	5	2	7	3	0	2	19
NONE	OG0000244	12	0	3	0	0	4	19
NONE	OG0000245	1	0	8	5	0	5	19
NONE	OG0000246	5	0	10	1	0	3	19
NONE	OG0000247	3	0	10	1	0	5	19
NONE	OG0000248	4	0	6	3	3	3	19
NONE	OG0000249	6	0	7	4	0	2	19
NONE	OG0000250	5	2	3	5	0	4	19
NONE	OG0000251	2	1	2	2	10	2	19
NONE	OG0000252	4	0	7	4	3	1	19
NONE	OG0000253	6	0	8	1	0	4	19
NONE	OG0000254	2	0	1	0	0	16	19
NONE	OG0000255	4	3	4	3	2	3	19
NONE	OG0000256	5	1	5	6	0	2	19
NONE	OG0000257	5	2	4	3	2	3	19
NONE	OG0000258	4	0	4	6	0	5	19
NONE	OG0000259	4	2	5	4	1	3	19
NONE	OG0000260	8	2	6	0	0	3	19
NONE	OG0000261	5	0	4	9	0	1	19
NONE	OG0000262	0	0	14	0	0	5	19
NONE	OG0000263	0	0	0	0	19	0	19
NONE	OG0000264	0	0	0	0	19	0	19
NONE	OG0000265	0	0	0	0	0	19	19
NONE	OG0000266	9	0	8	0	0	1	18
NONE	OG0000267	11	0	1	0	1	5	18
NONE	OG0000268	7	0	8	1	0	2	18
NONE	OG0000269	1	1	2	2	9	3	18
NONE	OG0000270	6	0	8	1	0	3	18
NONE	OG0000271	4	1	4	3	2	4	18
NONE	OG0000272	6	2	6	0	0	4	18
NONE	OG0000273	7	0	4	1	0	6	18
NONE	OG0000274	10	0	3	2	0	3	18
NONE	OG0000275	5	0	6	1	3	3	18
NONE	OG0000276	3	0	11	1	0	3	18
NONE	OG0000277	1	0	17	0	0	0	18
NONE	OG0000278	9	0	5	2	0	2	18
NONE	OG0000279	1	1	2	12	1	1	18
NONE	OG0000280	9	0	4	2	0	3	18
NONE	OG0000281	3	2	3	3	4	3	18
NONE	OG0000282	7	0	4	2	2	3	18
NONE	OG0000283	6	0	12	0	0	0	18
NONE	OG0000284	3	5	3	4	1	2	18
NONE	OG0000285	3	0	2	1	9	3	18
NONE	OG0000286	5	1	3	4	1	4	18
NONE	OG0000287	1	1	2	1	12	1	18
NONE	OG0000288	3	1	4	4	0	6	18
NONE	OG0000289	3	2	4	8	0	1	18
NONE	OG0000290	1	1	3	2	8	3	18
NONE	OG0000291	2	0	3	0	12	1	18
NONE	OG0000292	1	1	1	1	13	1	18
NONE	OG0000293	0	0	17	1	0	0	18
NONE	OG0000294	0	0	0	18	0	0	18
NONE	OG0000295	0	0	0	18	0	0	18
NONE	OG0000296	0	0	0	0	0	18	18
NONE	OG0000297	3	2	3	4	1	4	17
NONE	OG0000298	4	1	4	5	0	3	17
NONE	OG0000299	2	1	6	4	0	4	17
NONE	OG0000300	6	1	3	5	0	2	17
NONE	OG0000301	5	1	6	2	1	2	17
NONE	OG0000302	8	0	4	1	0	4	17
NONE	OG0000303	7	0	8	2	0	0	17
NONE	OG0000304	9	0	0	4	3	1	17
NONE	OG0000305	5	0	8	0	0	4	17
NONE	OG0000306	3	3	4	4	1	2	17
NONE	OG0000307	13	0	2	0	0	2	17
NONE	OG0000308	2	2	2	5	3	3	17
NONE	OG0000309	7	0	5	0	0	5	17
NONE	OG0000310	5	0	11	0	0	1	17
NONE	OG0000311	1	1	4	3	6	2	17
NONE	OG0000312	3	1	3	5	2	3	17
NONE	OG0000313	7	0	4	1	3	2	17
NONE	OG0000314	9	0	5	2	1	0	17
NONE	OG0000315	8	0	6	1	0	2	17
NONE	OG0000316	4	2	3	3	2	3	17
NONE	OG0000317	4	2	3	3	2	3	17
NONE	OG0000318	2	2	7	2	2	2	17
NONE	OG0000319	6	1	3	5	2	0	17
NONE	OG0000320	2	8	2	3	1	1	17
NONE	OG0000321	3	1	6	3	1	3	17
NONE	OG0000322	7	2	3	4	0	1	17
NONE	OG0000323	1	1	3	9	2	1	17
NONE	OG0000324	6	0	6	1	2	2	17
NONE	OG0000325	4	0	5	5	0	3	17
NONE	OG0000326	1	2	2	5	3	4	17
NONE	OG0000327	7	0	5	4	0	1	17
NONE	OG0000328	0	1	2	2	12	0	17
NONE	OG0000329	0	0	17	0	0	0	17
NONE	OG0000330	0	0	0	17	0	0	17
NONE	OG0000331	0	0	0	0	17	0	17
NONE	OG0000332	0	0	0	0	17	0	17
NONE	OG0000333	13	0	2	0	1	0	16
NONE	OG0000334	9	0	6	0	0	1	16
NONE	OG0000335	3	0	10	0	0	3	16
NONE	OG0000336	2	0	9	2	0	3	16
NONE	OG0000337	3	0	8	0	1	4	16
NONE	OG0000338	3	1	6	2	1	3	16
NONE	OG0000339	3	1	6	2	2	2	16
NONE	OG0000340	5	0	9	1	0	1	16
NONE	OG0000341	3	0	3	0	0	10	16
NONE	OG0000342	4	0	4	0	0	8	16
NONE	OG0000343	4	1	3	6	0	2	16
NONE	OG0000344	12	0	4	0	0	0	16
NONE	OG0000345	5	0	0	0	0	11	16
NONE	OG0000346	2	0	4	8	0	2	16
NONE	OG0000347	8	0	6	1	0	1	16
NONE	OG0000348	2	0	0	2	1	11	16
NONE	OG0000349	6	1	3	2	1	3	16
NONE	OG0000350	2	7	2	2	1	2	16
NONE	OG0000351	2	0	14	0	0	0	16
NONE	OG0000352	3	3	3	3	1	3	16
NONE	OG0000353	4	1	5	2	2	2	16
NONE	OG0000354	16	0	0	0	0	0	16
NONE	OG0000355	2	0	1	13	0	0	16
NONE	OG0000356	3	1	3	3	2	4	16
NONE	OG0000357	2	0	9	1	0	4	16
NONE	OG0000358	3	1	7	3	1	1	16
NONE	OG0000359	6	1	3	6	0	0	16
NONE	OG0000360	5	0	3	8	0	0	16
NONE	OG0000361	1	0	4	9	0	2	16
NONE	OG0000362	1	0	6	4	1	4	16
NONE	OG0000363	3	3	3	3	1	3	16
NONE	OG0000364	0	0	16	0	0	0	16
NONE	OG0000365	0	0	0	16	0	0	16
NONE	OG0000366	0	0	0	16	0	0	16
NONE	OG0000367	0	0	0	0	1	15	16
NONE	OG0000368	9	0	3	1	0	2	15
NONE	OG0000369	2	3	3	1	3	3	15
NONE	OG0000370	14	0	0	1	0	0	15
NONE	OG0000371	4	1	2	4	2	2	15
NONE	OG0000372	4	1	4	4	0	2	15
NONE	OG0000373	1	2	2	1	8	1	15
NONE	OG0000374	15	0	0	0	0	0	15
NONE	OG0000375	8	0	7	0	0	0	15
NONE	OG0000376	8	0	6	1	0	0	15
NONE	OG0000377	14	0	1	0	0	0	15
NONE	OG0000378	5	0	2	4	0	4	15
NONE	OG0000379	2	1	3	5	0	4	15
NONE	OG0000380	15	0	0	0	0	0	15
NONE	OG0000381	3	0	5	1	0	6	15
NONE	OG0000382	3	1	3	3	3	2	15
NONE	OG0000383	3	1	3	3	2	3	15
NONE	OG0000384	15	0	0	0	0	0	15
NONE	OG0000385	2	5	2	2	2	2	15
NONE	OG0000386	4	1	4	4	0	2	15
NONE	OG0000387	15	0	0	0	0	0	15
NONE	OG0000388	2	0	3	3	0	7	15
NONE	OG0000389	4	0	6	3	0	2	15
NONE	OG0000390	12	0	1	0	0	2	15
NONE	OG0000391	7	0	1	1	1	5	15
NONE	OG0000392	5	0	6	4	0	0	15
NONE	OG0000393	5	0	5	4	0	1	15
NONE	OG0000394	5	0	2	0	0	8	15
NONE	OG0000395	1	0	4	7	0	3	15
NONE	OG0000396	8	0	3	1	0	3	15
NONE	OG0000397	4	0	3	1	0	7	15
NONE	OG0000398	5	0	2	3	0	5	15
NONE	OG0000399	3	0	8	1	0	3	15
NONE	OG0000400	1	0	12	0	0	2	15
NONE	OG0000401	11	0	2	1	0	1	15
NONE	OG0000402	3	1	4	2	3	2	15
NONE	OG0000403	4	0	6	2	1	2	15
NONE	OG0000404	2	0	12	0	0	1	15
NONE	OG0000405	5	0	7	1	0	2	15
NONE	OG0000406	2	0	2	9	1	1	15
NONE	OG0000407	5	0	6	1	0	3	15
NONE	OG0000408	1	1	1	1	9	2	15
NONE	OG0000409	3	2	2	4	2	2	15
NONE	OG0000410	3	1	5	3	2	1	15
NONE	OG0000411	2	0	4	4	0	5	15
NONE	OG0000412	2	1	3	2	3	4	15
NONE	OG0000413	3	0	12	0	0	0	15
NONE	OG0000414	5	1	2	3	1	3	15
NONE	OG0000415	2	0	6	4	2	1	15
NONE	OG0000416	1	2	4	0	2	6	15
NONE	OG0000417	3	1	4	2	1	4	15
NONE	OG0000418	3	1	3	6	1	1	15
NONE	OG0000419	1	0	1	6	0	7	15
NONE	OG0000420	2	0	1	0	0	12	15
NONE	OG0000421	2	1	8	0	4	0	15
NONE	OG0000422	6	0	1	6	0	2	15
NONE	OG0000423	3	2	3	5	0	2	15
NONE	OG0000424	4	1	3	3	1	3	15
NONE	OG0000425	4	2	2	3	0	4	15
NONE	OG0000426	3	2	3	3	1	3	15
NONE	OG0000427	4	1	3	3	1	3	15
NONE	OG0000428	2	2	2	3	4	2	15
NONE	OG0000429	3	2	2	2	5	1	15
NONE	OG0000430	0	0	13	1	0	1	15
NONE	OG0000431	0	0	0	15	0	0	15
NONE	OG0000432	0	0	0	15	0	0	15
NONE	OG0000433	0	0	0	15	0	0	15
NONE	OG0000434	3	0	0	1	0	10	14
NONE	OG0000435	4	1	0	7	0	2	14
NONE	OG0000436	5	1	6	0	2	0	14
NONE	OG0000437	6	0	3	0	0	5	14
NONE	OG0000438	5	0	4	0	0	5	14
NONE	OG0000439	3	2	4	2	2	1	14
NONE	OG0000440	1	0	13	0	0	0	14
NONE	OG0000441	5	0	1	8	0	0	14
NONE	OG0000442	12	0	2	0	0	0	14
NONE	OG0000443	14	0	0	0	0	0	14
NONE	OG0000444	2	0	9	1	0	2	14
NONE	OG0000445	2	2	5	1	1	3	14
NONE	OG0000446	12	0	1	1	0	0	14
NONE	OG0000447	3	0	4	2	0	5	14
NONE	OG0000448	1	0	11	0	0	2	14
NONE	OG0000449	2	1	2	3	3	3	14
NONE	OG0000450	3	1	3	4	0	3	14
NONE	OG0000451	2	3	2	3	1	3	14
NONE	OG0000452	2	0	5	3	1	3	14
NONE	OG0000453	1	9	1	1	1	1	14
NONE	OG0000454	1	0	13	0	0	0	14
NONE	OG0000455	1	0	0	0	13	0	14
NONE	OG0000456	7	1	2	4	0	0	14
NONE	OG0000457	1	0	1	2	9	1	14
NONE	OG0000458	3	1	3	3	1	3	14
NONE	OG0000459	2	0	8	3	0	1	14
NONE	OG0000460	1	2	1	3	6	1	14
NONE	OG0000461	4	0	6	2	1	1	14
NONE	OG0000462	1	0	13	0	0	0	14
NONE	OG0000463	5	0	4	4	0	1	14
NONE	OG0000464	1	0	1	0	10	2	14
NONE	OG0000465	4	1	2	2	2	3	14
NONE	OG0000466	5	1	2	5	0	1	14
NONE	OG0000467	4	0	10	0	0	0	14
NONE	OG0000468	1	2	2	5	0	4	14
NONE	OG0000469	2	0	9	3	0	0	14
NONE	OG0000470	3	1	2	2	6	0	14
NONE	OG0000471	3	0	5	3	1	2	14
NONE	OG0000472	1	1	1	1	9	1	14
NONE	OG0000473	1	3	2	3	2	3	14
NONE	OG0000474	4	1	3	2	1	3	14
NONE	OG0000475	4	2	2	4	1	1	14
NONE	OG0000476	9	1	2	2	0	0	14
NONE	OG0000477	1	1	1	7	0	4	14
NONE	OG0000478	5	1	3	3	1	1	14
NONE	OG0000479	1	0	0	13	0	0	14
NONE	OG0000480	1	1	1	1	1	9	14
NONE	OG0000481	8	0	2	2	1	1	14
NONE	OG0000482	0	0	12	2	0	0	14
NONE	OG0000483	0	0	13	0	0	1	14
NONE	OG0000484	0	0	14	0	0	0	14
NONE	OG0000485	0	0	1	0	13	0	14
NONE	OG0000486	0	0	0	14	0	0	14
NONE	OG0000487	0	0	0	14	0	0	14
NONE	OG0000488	0	0	0	0	14	0	14
NONE	OG0000489	0	0	0	0	14	0	14
NONE	OG0000490	13	0	0	0	0	0	13
NONE	OG0000491	6	0	6	0	0	1	13
NONE	OG0000492	6	0	4	1	0	2	13
NONE	OG0000493	2	0	3	3	2	3	13
NONE	OG0000494	13	0	0	0	0	0	13
NONE	OG0000495	6	0	7	0	0	0	13
NONE	OG0000496	1	0	0	12	0	0	13
NONE	OG0000497	2	0	6	0	0	5	13
NONE	OG0000498	13	0	0	0	0	0	13
NONE	OG0000499	1	0	1	8	0	3	13
NONE	OG0000500	12	0	1	0	0	0	13
NONE	OG0000501	3	2	2	2	1	3	13
NONE	OG0000502	1	0	1	1	10	0	13
NONE	OG0000503	2	2	2	2	3	2	13
NONE	OG0000504	8	0	2	1	0	2	13
NONE	OG0000505	8	0	5	0	0	0	13
NONE	OG0000506	2	2	2	3	2	2	13
NONE	OG0000507	1	0	9	1	0	2	13
NONE	OG0000508	3	2	4	2	0	2	13
NONE	OG0000509	2	0	4	0	1	6	13
NONE	OG0000510	12	0	1	0	0	0	13
NONE	OG0000511	2	2	2	2	2	3	13
NONE	OG0000512	8	1	3	0	1	0	13
NONE	OG0000513	11	0	1	0	0	1	13
NONE	OG0000514	1	0	4	2	3	3	13
NONE	OG0000515	1	0	9	1	0	2	13
NONE	OG0000516	3	0	1	6	0	3	13
NONE	OG0000517	4	0	0	0	0	9	13
NONE	OG0000518	2	0	7	0	0	4	13
NONE	OG0000519	2	0	0	9	1	1	13
NONE	OG0000520	3	1	3	2	0	4	13
NONE	OG0000521	3	0	3	2	0	5	13
NONE	OG0000522	5	0	1	2	0	5	13
NONE	OG0000523	4	1	4	1	1	2	13
NONE	OG0000524	1	0	1	1	1	9	13
NONE	OG0000525	6	0	2	4	0	1	13
NONE	OG0000526	1	0	2	5	1	4	13
NONE	OG0000527	1	1	1	3	6	1	13
NONE	OG0000528	5	1	3	3	0	1	13
NONE	OG0000529	8	0	3	1	0	1	13
NONE	OG0000530	2	0	8	2	0	1	13
NONE	OG0000531	2	1	5	2	0	3	13
NONE	OG0000532	4	1	2	1	1	4	13
NONE	OG0000533	1	2	2	1	4	3	13
NONE	OG0000534	3	2	3	4	0	1	13
NONE	OG0000535	3	0	10	0	0	0	13
NONE	OG0000536	3	0	2	5	1	2	13
NONE	OG0000537	1	5	1	2	3	1	13
NONE	OG0000538	1	0	2	9	0	1	13
NONE	OG0000539	5	0	7	0	0	1	13
NONE	OG0000540	3	0	8	0	0	2	13
NONE	OG0000541	1	1	1	1	7	2	13
NONE	OG0000542	3	0	4	2	1	3	13
NONE	OG0000543	2	0	0	0	0	11	13
NONE	OG0000544	1	0	1	1	6	4	13
NONE	OG0000545	1	0	1	2	0	9	13
NONE	OG0000546	6	0	1	3	0	3	13
NONE	OG0000547	2	0	2	5	1	3	13
NONE	OG0000548	2	1	5	2	2	1	13
NONE	OG0000549	3	2	3	1	1	3	13
NONE	OG0000550	3	0	3	2	2	3	13
NONE	OG0000551	2	2	4	2	1	2	13
NONE	OG0000552	3	2	4	0	1	3	13
NONE	OG0000553	9	0	3	1	0	0	13
NONE	OG0000554	2	3	2	2	2	2	13
NONE	OG0000555	3	1	3	2	1	3	13
NONE	OG0000556	3	3	3	3	0	1	13
NONE	OG0000557	2	2	2	4	1	2	13
NONE	OG0000558	1	1	1	1	8	1	13
NONE	OG0000559	5	1	4	2	0	1	13
NONE	OG0000560	3	0	7	1	0	2	13
NONE	OG0000561	1	2	1	5	1	3	13
NONE	OG0000562	1	0	3	5	0	4	13
NONE	OG0000563	1	2	3	3	1	3	13
NONE	OG0000564	1	1	3	6	0	2	13
NONE	OG0000565	2	1	2	5	1	2	13
NONE	OG0000566	0	0	3	8	0	2	13
NONE	OG0000567	0	0	10	0	0	3	13
NONE	OG0000568	0	0	0	13	0	0	13
NONE	OG0000569	0	0	0	13	0	0	13
NONE	OG0000570	0	0	0	13	0	0	13
NONE	OG0000571	0	0	0	13	0	0	13
NONE	OG0000572	0	0	0	0	13	0	13
NONE	OG0000573	2	1	1	3	0	5	12
NONE	OG0000574	3	2	3	1	1	2	12
NONE	OG0000575	2	2	2	2	2	2	12
NONE	OG0000576	4	0	2	1	0	5	12
NONE	OG0000577	5	0	2	2	0	3	12
NONE	OG0000578	2	2	2	2	2	2	12
NONE	OG0000579	12	0	0	0	0	0	12
NONE	OG0000580	3	2	1	2	2	2	12
NONE	OG0000581	2	2	3	2	1	2	12
NONE	OG0000582	2	0	1	6	1	2	12
NONE	OG0000583	2	0	4	1	0	5	12
NONE	OG0000584	2	2	2	2	2	2	12
NONE	OG0000585	2	1	6	2	0	1	12
NONE	OG0000586	2	1	2	5	1	1	12
NONE	OG0000587	5	0	2	1	0	4	12
NONE	OG0000588	6	0	6	0	0	0	12
NONE	OG0000589	4	0	7	0	0	1	12
NONE	OG0000590	2	0	3	0	0	7	12
NONE	OG0000591	12	0	0	0	0	0	12
NONE	OG0000592	1	0	0	3	0	8	12
NONE	OG0000593	2	1	2	3	2	2	12
NONE	OG0000594	2	1	1	6	0	2	12
NONE	OG0000595	2	2	2	3	1	2	12
NONE	OG0000596	2	2	2	2	2	2	12
NONE	OG0000597	8	0	4	0	0	0	12
NONE	OG0000598	2	2	2	2	2	2	12
NONE	OG0000599	5	0	6	0	0	1	12
NONE	OG0000600	3	0	2	1	5	1	12
NONE	OG0000601	6	0	1	5	0	0	12
NONE	OG0000602	5	0	1	1	0	5	12
NONE	OG0000603	3	0	4	2	1	2	12
NONE	OG0000604	6	0	6	0	0	0	12
NONE	OG0000605	1	0	1	1	8	1	12
NONE	OG0000606	2	0	7	3	0	0	12
NONE	OG0000607	3	0	0	2	0	7	12
NONE	OG0000608	2	1	2	4	1	2	12
NONE	OG0000609	3	1	2	2	1	3	12
NONE	OG0000610	5	0	3	2	0	2	12
NONE	OG0000611	1	0	10	0	0	1	12
NONE	OG0000612	2	0	4	0	0	6	12
NONE	OG0000613	3	1	3	1	1	3	12
NONE	OG0000614	7	0	4	0	0	1	12
NONE	OG0000615	1	2	4	2	2	1	12
NONE	OG0000616	6	0	1	2	0	3	12
NONE	OG0000617	3	2	2	3	1	1	12
NONE	OG0000618	2	0	5	1	0	4	12
NONE	OG0000619	2	0	1	8	0	1	12
NONE	OG0000620	4	0	5	1	1	1	12
NONE	OG0000621	9	0	3	0	0	0	12
NONE	OG0000622	2	1	2	2	2	3	12
NONE	OG0000623	3	0	2	1	2	4	12
NONE	OG0000624	2	1	2	4	1	2	12
NONE	OG0000625	2	0	2	6	0	2	12
NONE	OG0000626	2	0	1	8	0	1	12
NONE	OG0000627	2	0	4	2	0	4	12
NONE	OG0000628	3	0	1	7	0	1	12
NONE	OG0000629	4	0	3	0	0	5	12
NONE	OG0000630	2	1	4	2	1	2	12
NONE	OG0000631	3	2	2	2	1	2	12
NONE	OG0000632	4	0	2	3	0	3	12
NONE	OG0000633	10	0	1	0	0	1	12
NONE	OG0000634	2	1	2	1	5	1	12
NONE	OG0000635	2	1	1	3	4	1	12
NONE	OG0000636	3	0	2	0	0	7	12
NONE	OG0000637	2	2	2	2	2	2	12
NONE	OG0000638	1	0	11	0	0	0	12
NONE	OG0000639	1	1	4	1	1	4	12
NONE	OG0000640	9	0	3	0	0	0	12
NONE	OG0000641	6	1	2	1	1	1	12
NONE	OG0000642	2	1	2	1	2	4	12
NONE	OG0000643	1	0	0	1	2	8	12
NONE	OG0000644	2	2	2	2	2	2	12
NONE	OG0000645	2	2	2	2	2	2	12
NONE	OG0000646	2	1	2	4	0	3	12
NONE	OG0000647	3	2	6	0	0	1	12
NONE	OG0000648	3	1	4	1	1	2	12
NONE	OG0000649	1	0	11	0	0	0	12
NONE	OG0000650	3	1	2	2	2	2	12
NONE	OG0000651	2	2	2	2	2	2	12
NONE	OG0000652	2	2	3	2	1	2	12
NONE	OG0000653	3	1	3	3	1	1	12
NONE	OG0000654	3	1	4	3	0	1	12
NONE	OG0000655	2	7	1	1	0	1	12
NONE	OG0000656	3	2	2	2	1	2	12
NONE	OG0000657	2	1	2	4	1	2	12
NONE	OG0000658	2	1	4	3	0	2	12
NONE	OG0000659	1	0	5	4	0	2	12
NONE	OG0000660	1	0	1	1	8	1	12
NONE	OG0000661	12	0	0	0	0	0	12
NONE	OG0000662	3	1	2	4	0	2	12
NONE	OG0000663	1	0	4	3	0	4	12
NONE	OG0000664	2	3	2	2	1	2	12
NONE	OG0000665	2	2	2	2	2	2	12
NONE	OG0000666	2	3	1	2	2	2	12
NONE	OG0000667	2	2	2	2	2	2	12
NONE	OG0000668	2	2	2	2	2	2	12
NONE	OG0000669	1	0	2	1	0	8	12
NONE	OG0000670	1	0	5	2	0	4	12
NONE	OG0000671	1	0	2	0	0	9	12
NONE	OG0000672	3	1	2	2	1	3	12
NONE	OG0000673	1	2	1	4	0	4	12
NONE	OG0000674	2	2	3	2	1	2	12
NONE	OG0000675	1	0	10	0	0	1	12
NONE	OG0000676	3	2	3	2	1	1	12
NONE	OG0000677	1	0	5	2	0	4	12
NONE	OG0000678	1	1	6	2	0	2	12
NONE	OG0000679	0	1	1	5	0	5	12
NONE	OG0000680	0	1	1	7	1	2	12
NONE	OG0000681	0	1	0	11	0	0	12
NONE	OG0000682	0	0	12	0	0	0	12
NONE	OG0000683	0	0	12	0	0	0	12
NONE	OG0000684	0	0	1	0	0	11	12
NONE	OG0000685	0	0	8	2	0	2	12
NONE	OG0000686	0	0	0	12	0	0	12
NONE	OG0000687	0	0	0	12	0	0	12
NONE	OG0000688	0	0	0	12	0	0	12
NONE	OG0000689	0	0	0	12	0	0	12
NONE	OG0000690	0	0	0	0	12	0	12
NONE	OG0000691	0	0	0	0	12	0	12
NONE	OG0000692	0	0	0	0	12	0	12
NONE	OG0000693	0	0	0	0	11	1	12
NONE	OG0000694	0	0	0	0	0	12	12
NONE	OG0000695	3	0	1	0	0	7	11
NONE	OG0000696	2	2	1	2	2	2	11
NONE	OG0000697	2	2	2	2	2	1	11
NONE	OG0000698	4	0	5	0	0	2	11
NONE	OG0000699	9	0	1	0	0	1	11
NONE	OG0000700	2	2	3	1	1	2	11
NONE	OG0000701	1	0	0	10	0	0	11
NONE	OG0000702	11	0	0	0	0	0	11
NONE	OG0000703	4	0	5	1	0	1	11
NONE	OG0000704	2	2	1	3	1	2	11
NONE	OG0000705	2	2	4	2	0	1	11
NONE	OG0000706	2	1	2	2	2	2	11
NONE	OG0000707	2	2	2	3	0	2	11
NONE	OG0000708	2	2	2	3	1	1	11
NONE	OG0000709	11	0	0	0	0	0	11
NONE	OG0000710	1	0	1	6	0	3	11
NONE	OG0000711	2	1	3	2	1	2	11
NONE	OG0000712	1	1	4	2	1	2	11
NONE	OG0000713	3	0	1	0	3	4	11
NONE	OG0000714	3	0	0	0	0	8	11
NONE	OG0000715	4	0	1	0	5	1	11
NONE	OG0000716	3	0	3	4	0	1	11
NONE	OG0000717	1	0	0	0	0	10	11
NONE	OG0000718	9	0	2	0	0	0	11
NONE	OG0000719	10	0	1	0	0	0	11
NONE	OG0000720	2	2	2	2	1	2	11
NONE	OG0000721	7	0	3	0	0	1	11
NONE	OG0000722	2	1	3	2	2	1	11
NONE	OG0000723	10	0	0	0	0	1	11
NONE	OG0000724	3	0	3	0	0	5	11
NONE	OG0000725	8	0	1	0	0	2	11
NONE	OG0000726	3	0	1	5	0	2	11
NONE	OG0000727	4	0	5	1	0	1	11
NONE	OG0000728	1	1	2	3	0	4	11
NONE	OG0000729	2	1	2	2	1	3	11
NONE	OG0000730	4	0	2	2	0	3	11
NONE	OG0000731	1	0	5	0	0	5	11
NONE	OG0000732	2	2	2	2	1	2	11
NONE	OG0000733	1	0	1	9	0	0	11
NONE	OG0000734	4	0	3	0	0	4	11
NONE	OG0000735	2	2	2	2	1	2	11
NONE	OG0000736	2	2	2	2	1	2	11
NONE	OG0000737	3	2	2	3	0	1	11
NONE	OG0000738	1	0	1	8	0	1	11
NONE	OG0000739	1	0	5	4	0	1	11
NONE	OG0000740	3	0	7	1	0	0	11
NONE	OG0000741	2	2	3	3	0	1	11
NONE	OG0000742	1	1	1	3	2	3	11
NONE	OG0000743	3	1	3	2	1	1	11
NONE	OG0000744	2	0	1	8	0	0	11
NONE	OG0000745	3	2	2	3	0	1	11
NONE	OG0000746	2	2	2	2	1	2	11
NONE	OG0000747	1	2	3	3	1	1	11
NONE	OG0000748	2	1	5	1	1	1	11
NONE	OG0000749	3	1	1	2	2	2	11
NONE	OG0000750	3	0	1	6	1	0	11
NONE	OG0000751	1	1	3	2	0	4	11
NONE	OG0000752	11	0	0	0	0	0	11
NONE	OG0000753	2	0	7	0	0	2	11
NONE	OG0000754	11	0	0	0	0	0	11
NONE	OG0000755	9	0	0	0	1	1	11
NONE	OG0000756	3	1	1	4	0	2	11
NONE	OG0000757	2	2	2	2	1	2	11
NONE	OG0000758	1	0	4	0	0	6	11
NONE	OG0000759	2	1	4	1	1	2	11
NONE	OG0000760	2	1	6	1	0	1	11
NONE	OG0000761	2	1	3	2	2	1	11
NONE	OG0000762	3	0	2	1	2	3	11
NONE	OG0000763	4	1	2	3	0	1	11
NONE	OG0000764	2	2	2	2	1	2	11
NONE	OG0000765	3	0	3	2	1	2	11
NONE	OG0000766	2	2	2	2	2	1	11
NONE	OG0000767	2	0	9	0	0	0	11
NONE	OG0000768	3	0	5	2	0	1	11
NONE	OG0000769	2	2	2	3	0	2	11
NONE	OG0000770	1	0	2	4	0	4	11
NONE	OG0000771	4	0	4	0	0	3	11
NONE	OG0000772	4	0	2	0	1	4	11
NONE	OG0000773	3	2	1	2	2	1	11
NONE	OG0000774	2	0	5	1	0	3	11
NONE	OG0000775	2	1	2	2	1	3	11
NONE	OG0000776	2	2	2	2	1	2	11
NONE	OG0000777	2	2	2	1	3	1	11
NONE	OG0000778	2	0	2	7	0	0	11
NONE	OG0000779	5	0	5	0	0	1	11
NONE	OG0000780	4	1	3	2	1	0	11
NONE	OG0000781	1	1	1	1	6	1	11
NONE	OG0000782	1	1	6	1	1	1	11
NONE	OG0000783	1	0	10	0	0	0	11
NONE	OG0000784	2	2	2	2	1	2	11
NONE	OG0000785	4	0	5	0	0	2	11
NONE	OG0000786	2	2	2	2	1	2	11
NONE	OG0000787	2	1	2	2	1	3	11
NONE	OG0000788	1	3	2	3	2	0	11
NONE	OG0000789	2	1	2	3	1	2	11
NONE	OG0000790	5	0	2	0	1	3	11
NONE	OG0000791	3	1	1	2	2	2	11
NONE	OG0000792	1	3	1	3	1	2	11
NONE	OG0000793	2	2	2	2	1	2	11
NONE	OG0000794	1	1	1	4	3	1	11
NONE	OG0000795	2	0	8	0	0	1	11
NONE	OG0000796	2	2	2	2	1	2	11
NONE	OG0000797	11	0	0	0	0	0	11
NONE	OG0000798	2	0	5	0	0	4	11
NONE	OG0000799	2	1	2	2	1	3	11
NONE	OG0000800	3	1	2	3	0	2	11
NONE	OG0000801	2	1	2	2	2	2	11
NONE	OG0000802	3	0	3	3	0	2	11
NONE	OG0000803	1	0	1	9	0	0	11
NONE	OG0000804	1	2	2	3	0	3	11
NONE	OG0000805	4	0	4	2	1	0	11
NONE	OG0000806	3	1	3	2	0	2	11
NONE	OG0000807	2	0	2	2	3	2	11
NONE	OG0000808	2	1	2	3	0	3	11
NONE	OG0000809	2	1	2	3	1	2	11
NONE	OG0000810	3	1	2	2	1	2	11
NONE	OG0000811	2	0	2	5	0	2	11
NONE	OG0000812	2	0	7	1	0	1	11
NONE	OG0000813	1	1	2	2	3	2	11
NONE	OG0000814	0	0	9	0	0	2	11
NONE	OG0000815	0	0	11	0	0	0	11
NONE	OG0000816	0	0	11	0	0	0	11
NONE	OG0000817	0	0	11	0	0	0	11
NONE	OG0000818	0	0	11	0	0	0	11
NONE	OG0000819	0	0	1	0	0	10	11
NONE	OG0000820	0	0	1	0	0	10	11
NONE	OG0000821	0	0	1	0	0	10	11
NONE	OG0000822	0	0	0	11	0	0	11
NONE	OG0000823	0	0	0	10	0	1	11
NONE	OG0000824	0	0	0	11	0	0	11
NONE	OG0000825	0	0	0	11	0	0	11
NONE	OG0000826	0	0	0	0	11	0	11
NONE	OG0000827	0	0	0	0	11	0	11
NONE	OG0000828	0	0	0	0	11	0	11
NONE	OG0000829	0	0	0	0	11	0	11
NONE	OG0000830	0	0	0	0	11	0	11
NONE	OG0000831	0	0	0	0	11	0	11
NONE	OG0000832	0	0	0	0	0	11	11
NONE	OG0000833	0	0	0	0	0	11	11
NONE	OG0000834	0	0	0	0	0	11	11
NONE	OG0000835	0	0	0	0	0	11	11
NONE	OG0000836	2	1	2	2	1	2	10
NONE	OG0000837	1	0	9	0	0	0	10
NONE	OG0000838	2	1	3	2	0	2	10
NONE	OG0000839	5	0	5	0	0	0	10
NONE	OG0000840	9	0	1	0	0	0	10
NONE	OG0000841	3	0	3	1	0	3	10
NONE	OG0000842	6	0	2	1	0	1	10
NONE	OG0000843	1	2	5	1	0	1	10
NONE	OG0000844	4	1	2	1	0	2	10
NONE	OG0000845	3	0	6	0	1	0	10
NONE	OG0000846	9	0	1	0	0	0	10
NONE	OG0000847	2	2	2	1	2	1	10
NONE	OG0000848	2	1	2	3	0	2	10
NONE	OG0000849	1	0	0	0	0	9	10
NONE	OG0000850	1	1	1	1	5	1	10
NONE	OG0000851	5	0	1	2	0	2	10
NONE	OG0000852	3	0	5	0	0	2	10
NONE	OG0000853	2	1	2	2	1	2	10
NONE	OG0000854	10	0	0	0	0	0	10
NONE	OG0000855	9	0	1	0	0	0	10
NONE	OG0000856	2	2	2	2	0	2	10
NONE	OG0000857	7	0	2	0	0	1	10
NONE	OG0000858	2	3	1	2	1	1	10
NONE	OG0000859	5	0	5	0	0	0	10
NONE	OG0000860	2	2	2	1	1	2	10
NONE	OG0000861	2	1	2	0	5	0	10
NONE	OG0000862	2	0	7	1	0	0	10
NONE	OG0000863	1	0	0	0	0	9	10
NONE	OG0000864	8	0	2	0	0	0	10
NONE	OG0000865	2	2	2	3	0	1	10
NONE	OG0000866	2	1	3	2	1	1	10
NONE	OG0000867	6	0	4	0	0	0	10
NONE	OG0000868	1	1	3	3	1	1	10
NONE	OG0000869	2	1	2	1	1	3	10
NONE	OG0000870	3	0	3	2	0	2	10
NONE	OG0000871	2	0	4	2	0	2	10
NONE	OG0000872	2	0	7	0	0	1	10
NONE	OG0000873	3	1	2	1	2	1	10
NONE	OG0000874	10	0	0	0	0	0	10
NONE	OG0000875	1	1	3	1	2	2	10
NONE	OG0000876	2	0	0	0	8	0	10
NONE	OG0000877	3	0	4	0	0	3	10
NONE	OG0000878	2	2	2	2	1	1	10
NONE	OG0000879	1	1	3	1	1	3	10
NONE	OG0000880	8	0	1	1	0	0	10
NONE	OG0000881	2	2	2	2	1	1	10
NONE	OG0000882	4	0	3	2	0	1	10
NONE	OG0000883	2	1	1	1	3	2	10
NONE	OG0000884	10	0	0	0	0	0	10
NONE	OG0000885	4	0	4	1	0	1	10
NONE	OG0000886	1	1	1	2	3	2	10
NONE	OG0000887	8	0	1	1	0	0	10
NONE	OG0000888	1	1	2	3	0	3	10
NONE	OG0000889	1	0	5	2	0	2	10
NONE	OG0000890	3	1	0	0	0	6	10
NONE	OG0000891	2	0	5	0	0	3	10
NONE	OG0000892	1	1	5	1	1	1	10
NONE	OG0000893	2	1	4	1	1	1	10
NONE	OG0000894	1	1	6	1	0	1	10
NONE	OG0000895	1	0	0	7	0	2	10
NONE	OG0000896	2	1	3	2	1	1	10
NONE	OG0000897	2	1	3	1	2	1	10
NONE	OG0000898	3	0	2	0	0	5	10
NONE	OG0000899	1	0	8	0	0	1	10
NONE	OG0000900	6	0	1	1	0	2	10
NONE	OG0000901	1	1	1	3	3	1	10
NONE	OG0000902	3	0	2	2	1	2	10
NONE	OG0000903	5	0	4	1	0	0	10
NONE	OG0000904	2	2	2	2	1	1	10
NONE	OG0000905	4	0	6	0	0	0	10
NONE	OG0000906	2	1	1	4	1	1	10
NONE	OG0000907	2	1	2	2	1	2	10
NONE	OG0000908	4	0	4	0	1	1	10
NONE	OG0000909	10	0	0	0	0	0	10
NONE	OG0000910	1	1	4	2	1	1	10
NONE	OG0000911	2	1	3	1	1	2	10
NONE	OG0000912	1	1	5	1	1	1	10
NONE	OG0000913	1	0	8	0	0	1	10
NONE	OG0000914	10	0	0	0	0	0	10
NONE	OG0000915	2	1	2	2	1	2	10
NONE	OG0000916	2	1	1	4	1	1	10
NONE	OG0000917	4	0	2	0	0	4	10
NONE	OG0000918	5	0	3	1	0	1	10
NONE	OG0000919	1	0	5	1	0	3	10
NONE	OG0000920	2	2	4	0	2	0	10
NONE	OG0000921	2	1	4	1	1	1	10
NONE	OG0000922	2	0	3	2	1	2	10
NONE	OG0000923	1	0	7	0	0	2	10
NONE	OG0000924	2	0	6	0	0	2	10
NONE	OG0000925	2	0	2	1	0	5	10
NONE	OG0000926	1	1	1	1	2	4	10
NONE	OG0000927	2	0	2	5	0	1	10
NONE	OG0000928	2	2	1	2	2	1	10
NONE	OG0000929	1	1	2	4	1	1	10
NONE	OG0000930	1	0	8	0	1	0	10
NONE	OG0000931	5	1	1	1	1	1	10
NONE	OG0000932	2	2	2	2	1	1	10
NONE	OG0000933	2	1	2	2	1	2	10
NONE	OG0000934	1	1	1	6	0	1	10
NONE	OG0000935	1	0	1	0	0	8	10
NONE	OG0000936	3	0	7	0	0	0	10
NONE	OG0000937	1	1	5	1	1	1	10
NONE	OG0000938	1	0	4	0	0	5	10
NONE	OG0000939	4	1	2	1	0	2	10
NONE	OG0000940	2	2	4	1	0	1	10
NONE	OG0000941	2	1	2	2	1	2	10
NONE	OG0000942	1	0	4	0	1	4	10
NONE	OG0000943	3	0	5	1	0	1	10
NONE	OG0000944	1	1	3	3	0	2	10
NONE	OG0000945	2	0	2	3	0	3	10
NONE	OG0000946	2	2	2	1	1	2	10
NONE	OG0000947	4	1	2	1	0	2	10
NONE	OG0000948	1	1	2	3	1	2	10
NONE	OG0000949	2	0	3	2	0	3	10
NONE	OG0000950	1	3	2	2	1	1	10
NONE	OG0000951	3	1	3	2	0	1	10
NONE	OG0000952	2	2	2	1	1	2	10
NONE	OG0000953	4	0	5	1	0	0	10
NONE	OG0000954	1	1	2	5	1	0	10
NONE	OG0000955	1	0	2	7	0	0	10
NONE	OG0000956	2	1	2	1	2	2	10
NONE	OG0000957	1	0	2	2	0	5	10
NONE	OG0000958	4	0	4	1	0	1	10
NONE	OG0000959	4	0	3	1	0	2	10
NONE	OG0000960	1	0	5	0	0	4	10
NONE	OG0000961	1	1	2	4	1	1	10
NONE	OG0000962	2	1	1	2	3	1	10
NONE	OG0000963	3	0	1	1	4	1	10
NONE	OG0000964	1	2	2	2	1	2	10
NONE	OG0000965	1	0	1	0	0	8	10
NONE	OG0000966	2	2	1	2	1	2	10
NONE	OG0000967	1	0	1	5	0	3	10
NONE	OG0000968	1	4	1	3	0	1	10
NONE	OG0000969	2	2	2	1	1	2	10
NONE	OG0000970	2	3	1	1	1	2	10
NONE	OG0000971	3	2	2	1	1	1	10
NONE	OG0000972	2	1	2	4	0	1	10
NONE	OG0000973	1	4	1	1	2	1	10
NONE	OG0000974	2	1	2	3	1	1	10
NONE	OG0000975	2	1	2	2	1	2	10
NONE	OG0000976	3	1	3	2	0	1	10
NONE	OG0000977	2	2	3	2	0	1	10
NONE	OG0000978	2	0	4	2	0	2	10
NONE	OG0000979	2	0	4	2	0	2	10
NONE	OG0000980	2	3	2	1	1	1	10
NONE	OG0000981	2	1	2	2	1	2	10
NONE	OG0000982	2	2	3	2	0	1	10
NONE	OG0000983	3	0	5	1	0	1	10
NONE	OG0000984	2	3	1	1	1	2	10
NONE	OG0000985	1	2	1	1	4	1	10
NONE	OG0000986	1	3	2	2	1	1	10
NONE	OG0000987	1	0	3	2	3	1	10
NONE	OG0000988	2	0	2	3	0	3	10
NONE	OG0000989	1	1	4	2	2	0	10
NONE	OG0000990	2	1	1	4	1	1	10
NONE	OG0000991	2	1	2	3	0	2	10
NONE	OG0000992	2	0	3	2	0	3	10
NONE	OG0000993	2	2	1	3	1	1	10
NONE	OG0000994	0	10	0	0	0	0	10
NONE	OG0000995	0	10	0	0	0	0	10
NONE	OG0000996	0	0	10	0	0	0	10
NONE	OG0000997	0	0	1	2	0	7	10
NONE	OG0000998	0	0	0	10	0	0	10
NONE	OG0000999	0	0	0	10	0	0	10
NONE	OG0001000	0	0	0	10	0	0	10
NONE	OG0001001	0	0	0	10	0	0	10
NONE	OG0001002	0	0	0	10	0	0	10
NONE	OG0001003	0	0	0	10	0	0	10
NONE	OG0001004	0	0	0	1	0	9	10
NONE	OG0001005	0	0	0	10	0	0	10
NONE	OG0001006	0	0	0	10	0	0	10
NONE	OG0001007	0	0	0	9	0	1	10
NONE	OG0001008	0	0	0	2	8	0	10
NONE	OG0001009	0	0	0	4	0	6	10
NONE	OG0001010	0	0	0	10	0	0	10
NONE	OG0001011	0	0	0	0	10	0	10
NONE	OG0001012	0	0	0	0	10	0	10
NONE	OG0001013	0	0	0	0	10	0	10
NONE	OG0001014	0	0	0	0	10	0	10
NONE	OG0001015	0	0	0	0	0	10	10
NONE	OG0001016	0	0	0	0	0	10	10
NONE	OG0001017	2	1	1	3	1	1	9
NONE	OG0001018	1	0	6	1	0	1	9
NONE	OG0001019	8	0	1	0	0	0	9
NONE	OG0001020	3	1	2	1	1	1	9
NONE	OG0001021	9	0	0	0	0	0	9
NONE	OG0001022	9	0	0	0	0	0	9
NONE	OG0001023	3	0	6	0	0	0	9
NONE	OG0001024	2	1	2	1	2	1	9
NONE	OG0001025	6	0	1	0	0	2	9
NONE	OG0001026	1	1	3	2	1	1	9
NONE	OG0001027	2	1	2	1	2	1	9
NONE	OG0001028	7	0	1	1	0	0	9
NONE	OG0001029	1	0	5	3	0	0	9
NONE	OG0001030	9	0	0	0	0	0	9
NONE	OG0001031	1	0	2	0	0	6	9
NONE	OG0001032	5	0	2	2	0	0	9
NONE	OG0001033	6	0	2	0	0	1	9
NONE	OG0001034	1	1	4	1	1	1	9
NONE	OG0001035	1	1	4	1	1	1	9
NONE	OG0001036	5	0	3	0	0	1	9
NONE	OG0001037	5	0	2	2	0	0	9
NONE	OG0001038	2	1	1	1	2	2	9
NONE	OG0001039	1	1	4	1	1	1	9
NONE	OG0001040	1	1	4	1	1	1	9
NONE	OG0001041	2	1	1	2	1	2	9
NONE	OG0001042	2	2	1	2	0	2	9
NONE	OG0001043	3	0	0	2	0	4	9
NONE	OG0001044	2	0	3	1	0	3	9
NONE	OG0001045	2	0	3	1	1	2	9
NONE	OG0001046	5	0	4	0	0	0	9
NONE	OG0001047	9	0	0	0	0	0	9
NONE	OG0001048	9	0	0	0	0	0	9
NONE	OG0001049	2	0	1	1	0	5	9
NONE	OG0001050	1	1	1	4	1	1	9
NONE	OG0001051	1	1	1	5	0	1	9
NONE	OG0001052	1	1	1	4	1	1	9
NONE	OG0001053	2	1	2	2	1	1	9
NONE	OG0001054	1	0	2	3	0	3	9
NONE	OG0001055	4	0	3	0	0	2	9
NONE	OG0001056	2	1	2	2	1	1	9
NONE	OG0001057	2	0	3	0	0	4	9
NONE	OG0001058	2	1	3	1	1	1	9
NONE	OG0001059	6	0	2	0	0	1	9
NONE	OG0001060	3	1	2	1	1	1	9
NONE	OG0001061	2	0	2	3	0	2	9
NONE	OG0001062	1	2	2	1	2	1	9
NONE	OG0001063	5	0	3	0	1	0	9
NONE	OG0001064	1	0	6	1	0	1	9
NONE	OG0001065	2	0	2	2	1	2	9
NONE	OG0001066	2	1	2	2	1	1	9
NONE	OG0001067	2	2	1	1	2	1	9
NONE	OG0001068	1	5	1	1	0	1	9
NONE	OG0001069	5	0	4	0	0	0	9
NONE	OG0001070	1	1	1	1	1	4	9
NONE	OG0001071	2	3	1	1	1	1	9
NONE	OG0001072	1	0	8	0	0	0	9
NONE	OG0001073	1	2	1	4	0	1	9
NONE	OG0001074	9	0	0	0	0	0	9
NONE	OG0001075	1	1	1	2	2	2	9
NONE	OG0001076	5	0	1	0	0	3	9
NONE	OG0001077	8	0	1	0	0	0	9
NONE	OG0001078	9	0	0	0	0	0	9
NONE	OG0001079	1	1	2	1	2	2	9
NONE	OG0001080	2	1	2	1	1	2	9
NONE	OG0001081	4	0	4	0	0	1	9
NONE	OG0001082	2	1	2	1	1	2	9
NONE	OG0001083	2	1	2	2	1	1	9
NONE	OG0001084	2	2	2	1	1	1	9
NONE	OG0001085	3	1	2	1	0	2	9
NONE	OG0001086	3	0	4	1	0	1	9
NONE	OG0001087	1	0	1	5	0	2	9
NONE	OG0001088	2	1	1	2	1	2	9
NONE	OG0001089	1	0	7	0	0	1	9
NONE	OG0001090	4	1	1	1	1	1	9
NONE	OG0001091	1	1	1	4	1	1	9
NONE	OG0001092	1	0	8	0	0	0	9
NONE	OG0001093	3	1	2	1	1	1	9
NONE	OG0001094	1	0	1	0	6	1	9
NONE	OG0001095	2	3	1	1	1	1	9
NONE	OG0001096	1	1	1	4	1	1	9
NONE	OG0001097	2	2	1	1	1	2	9
NONE	OG0001098	9	0	0	0	0	0	9
NONE	OG0001099	4	0	2	2	0	1	9
NONE	OG0001100	3	0	3	0	0	3	9
NONE	OG0001101	1	4	1	1	1	1	9
NONE	OG0001102	2	1	1	3	0	2	9
NONE	OG0001103	2	1	2	4	0	0	9
NONE	OG0001104	7	0	1	1	0	0	9
NONE	OG0001105	2	0	5	0	1	1	9
NONE	OG0001106	1	1	1	4	1	1	9
NONE	OG0001107	2	0	2	2	1	2	9
NONE	OG0001108	2	0	3	2	0	2	9
NONE	OG0001109	4	0	1	2	0	2	9
NONE	OG0001110	2	1	1	3	1	1	9
NONE	OG0001111	1	1	2	2	2	1	9
NONE	OG0001112	4	2	1	1	0	1	9
NONE	OG0001113	2	0	6	0	0	1	9
NONE	OG0001114	1	1	2	1	1	3	9
NONE	OG0001115	1	1	4	1	1	1	9
NONE	OG0001116	3	0	2	0	0	4	9
NONE	OG0001117	2	0	2	0	0	5	9
NONE	OG0001118	5	0	4	0	0	0	9
NONE	OG0001119	5	1	1	1	0	1	9
NONE	OG0001120	1	2	2	1	1	2	9
NONE	OG0001121	2	1	2	2	0	2	9
NONE	OG0001122	1	0	3	0	0	5	9
NONE	OG0001123	1	3	2	1	1	1	9
NONE	OG0001124	3	1	2	1	1	1	9
NONE	OG0001125	2	1	4	0	1	1	9
NONE	OG0001126	3	1	4	0	0	1	9
NONE	OG0001127	3	2	2	1	0	1	9
NONE	OG0001128	1	1	3	2	1	1	9
NONE	OG0001129	1	1	4	1	1	1	9
NONE	OG0001130	1	1	4	1	1	1	9
NONE	OG0001131	1	1	4	1	1	1	9
NONE	OG0001132	2	1	3	1	1	1	9
NONE	OG0001133	1	1	2	2	1	2	9
NONE	OG0001134	1	2	2	2	1	1	9
NONE	OG0001135	2	0	2	2	1	2	9
NONE	OG0001136	5	0	1	0	0	3	9
NONE	OG0001137	4	0	2	1	0	2	9
NONE	OG0001138	2	0	2	1	0	4	9
NONE	OG0001139	2	2	3	1	0	1	9
NONE	OG0001140	2	1	2	1	1	2	9
NONE	OG0001141	3	0	1	0	0	5	9
NONE	OG0001142	2	3	1	1	0	2	9
NONE	OG0001143	2	0	4	0	0	3	9
NONE	OG0001144	4	0	0	0	0	5	9
NONE	OG0001145	2	1	3	1	1	1	9
NONE	OG0001146	1	1	2	3	1	1	9
NONE	OG0001147	1	1	1	4	1	1	9
NONE	OG0001148	2	0	2	2	1	2	9
NONE	OG0001149	1	2	3	1	1	1	9
NONE	OG0001150	2	1	2	2	1	1	9
NONE	OG0001151	7	0	1	0	0	1	9
NONE	OG0001152	1	1	1	2	3	1	9
NONE	OG0001153	1	4	1	1	1	1	9
NONE	OG0001154	4	0	1	0	0	4	9
NONE	OG0001155	1	1	1	1	4	1	9
NONE	OG0001156	2	3	1	1	1	1	9
NONE	OG0001157	2	1	2	2	0	2	9
NONE	OG0001158	2	2	2	1	1	1	9
NONE	OG0001159	6	0	3	0	0	0	9
NONE	OG0001160	2	2	2	1	1	1	9
NONE	OG0001161	2	0	4	0	0	3	9
NONE	OG0001162	2	0	2	2	1	2	9
NONE	OG0001163	1	1	3	2	1	1	9
NONE	OG0001164	1	1	3	1	1	2	9
NONE	OG0001165	9	0	0	0	0	0	9
NONE	OG0001166	3	0	4	1	0	1	9
NONE	OG0001167	1	0	2	3	0	3	9
NONE	OG0001168	1	1	3	2	1	1	9
NONE	OG0001169	2	0	2	2	1	2	9
NONE	OG0001170	3	0	0	0	0	6	9
NONE	OG0001171	1	0	1	7	0	0	9
NONE	OG0001172	2	0	5	1	0	1	9
NONE	OG0001173	2	1	2	1	1	2	9
NONE	OG0001174	2	2	1	1	2	1	9
NONE	OG0001175	5	0	3	0	0	1	9
NONE	OG0001176	1	2	1	2	2	1	9
NONE	OG0001177	1	1	3	1	2	1	9
NONE	OG0001178	1	1	3	3	0	1	9
NONE	OG0001179	2	0	4	0	0	3	9
NONE	OG0001180	2	1	1	1	2	2	9
NONE	OG0001181	1	0	4	0	0	4	9
NONE	OG0001182	1	1	2	3	2	0	9
NONE	OG0001183	8	0	0	1	0	0	9
NONE	OG0001184	1	0	4	1	0	3	9
NONE	OG0001185	1	1	2	2	2	1	9
NONE	OG0001186	2	1	2	1	1	2	9
NONE	OG0001187	1	1	2	2	1	2	9
NONE	OG0001188	2	1	2	1	1	2	9
NONE	OG0001189	1	1	3	2	1	1	9
NONE	OG0001190	1	2	0	6	0	0	9
NONE	OG0001191	2	1	1	3	1	1	9
NONE	OG0001192	3	0	3	1	1	1	9
NONE	OG0001193	3	1	1	2	1	1	9
NONE	OG0001194	1	1	1	4	1	1	9
NONE	OG0001195	2	0	5	0	0	2	9
NONE	OG0001196	1	1	3	1	2	1	9
NONE	OG0001197	1	2	1	1	1	3	9
NONE	OG0001198	1	3	1	1	2	1	9
NONE	OG0001199	1	2	1	2	2	1	9
NONE	OG0001200	2	1	3	1	1	1	9
NONE	OG0001201	1	1	4	1	1	1	9
NONE	OG0001202	1	1	4	1	1	1	9
NONE	OG0001203	1	1	4	1	1	1	9
NONE	OG0001204	2	1	3	1	1	1	9
NONE	OG0001205	1	0	2	5	1	0	9
NONE	OG0001206	2	1	2	1	1	2	9
NONE	OG0001207	3	0	3	2	0	1	9
NONE	OG0001208	2	1	1	1	3	1	9
NONE	OG0001209	4	1	1	1	1	1	9
NONE	OG0001210	2	2	2	1	1	1	9
NONE	OG0001211	4	0	2	1	1	1	9
NONE	OG0001212	1	1	4	1	1	1	9
NONE	OG0001213	1	0	3	1	0	4	9
NONE	OG0001214	1	1	2	3	1	1	9
NONE	OG0001215	2	1	2	3	0	1	9
NONE	OG0001216	2	1	1	4	0	1	9
NONE	OG0001217	1	0	1	6	0	1	9
NONE	OG0001218	2	1	2	2	1	1	9
NONE	OG0001219	2	0	1	4	0	2	9
NONE	OG0001220	2	1	2	1	2	1	9
NONE	OG0001221	1	0	8	0	0	0	9
NONE	OG0001222	1	0	3	1	3	1	9
NONE	OG0001223	2	0	2	3	0	2	9
NONE	OG0001224	6	0	3	0	0	0	9
NONE	OG0001225	1	0	0	0	0	8	9
NONE	OG0001226	2	4	1	1	0	1	9
NONE	OG0001227	4	0	1	4	0	0	9
NONE	OG0001228	2	1	2	1	2	1	9
NONE	OG0001229	1	0	1	2	4	1	9
NONE	OG0001230	1	1	2	1	2	2	9
NONE	OG0001231	1	0	1	7	0	0	9
NONE	OG0001232	5	0	3	1	0	0	9
NONE	OG0001233	3	2	1	2	0	1	9
NONE	OG0001234	2	1	1	3	1	1	9
NONE	OG0001235	1	1	1	2	3	1	9
NONE	OG0001236	2	2	1	1	1	2	9
NONE	OG0001237	2	1	1	3	1	1	9
NONE	OG0001238	1	0	4	0	0	4	9
NONE	OG0001239	2	1	3	2	0	1	9
NONE	OG0001240	1	1	2	4	0	1	9
NONE	OG0001241	2	0	3	1	2	1	9
NONE	OG0001242	1	3	1	1	0	3	9
NONE	OG0001243	1	0	2	3	1	2	9
NONE	OG0001244	1	0	5	0	1	2	9
NONE	OG0001245	1	2	1	2	1	2	9
NONE	OG0001246	1	1	2	1	0	4	9
NONE	OG0001247	1	0	3	2	0	3	9
NONE	OG0001248	2	0	4	3	0	0	9
NONE	OG0001249	1	1	3	2	1	1	9
NONE	OG0001250	1	1	1	4	1	1	9
NONE	OG0001251	3	2	2	0	0	2	9
NONE	OG0001252	1	2	1	2	2	1	9
NONE	OG0001253	1	3	0	2	1	2	9
NONE	OG0001254	1	1	3	2	1	1	9
NONE	OG0001255	2	3	1	2	0	1	9
NONE	OG0001256	1	0	6	0	0	2	9
NONE	OG0001257	1	1	2	2	2	1	9
NONE	OG0001258	1	1	3	2	1	1	9
NONE	OG0001259	2	0	2	2	1	2	9
NONE	OG0001260	1	2	1	3	1	1	9
NONE	OG0001261	3	0	0	5	0	1	9
NONE	OG0001262	1	1	4	1	1	1	9
NONE	OG0001263	1	1	4	1	1	1	9
NONE	OG0001264	1	1	4	1	1	1	9
NONE	OG0001265	1	1	4	1	1	1	9
NONE	OG0001266	2	0	2	2	1	2	9
NONE	OG0001267	2	2	3	1	0	1	9
NONE	OG0001268	2	0	2	2	1	2	9
NONE	OG0001269	2	1	2	2	1	1	9
NONE	OG0001270	1	1	1	2	3	1	9
NONE	OG0001271	2	1	1	1	3	1	9
NONE	OG0001272	1	3	1	1	2	1	9
NONE	OG0001273	2	2	2	1	1	1	9
NONE	OG0001274	1	1	1	1	3	2	9
NONE	OG0001275	1	0	3	1	1	3	9
NONE	OG0001276	1	6	2	0	0	0	9
NONE	OG0001277	1	1	3	2	0	2	9
NONE	OG0001278	2	0	7	0	0	0	9
NONE	OG0001279	1	1	1	1	4	1	9
NONE	OG0001280	1	1	1	4	1	1	9
NONE	OG0001281	0	2	3	1	1	2	9
NONE	OG0001282	0	9	0	0	0	0	9
NONE	OG0001283	0	1	4	3	0	1	9
NONE	OG0001284	0	1	1	1	5	1	9
NONE	OG0001285	0	1	1	4	0	3	9
NONE	OG0001286	0	0	9	0	0	0	9
NONE	OG0001287	0	0	9	0	0	0	9
NONE	OG0001288	0	0	9	0	0	0	9
NONE	OG0001289	0	0	2	1	0	6	9
NONE	OG0001290	0	0	2	0	6	1	9
NONE	OG0001291	0	0	8	0	0	1	9
NONE	OG0001292	0	0	3	0	0	6	9
NONE	OG0001293	0	0	8	0	0	1	9
NONE	OG0001294	0	0	5	1	0	3	9
NONE	OG0001295	0	0	0	9	0	0	9
NONE	OG0001296	0	0	0	8	0	1	9
NONE	OG0001297	0	0	0	9	0	0	9
NONE	OG0001298	0	0	0	9	0	0	9
NONE	OG0001299	0	0	0	9	0	0	9
NONE	OG0001300	0	0	0	8	0	1	9
NONE	OG0001301	0	0	0	1	0	8	9
NONE	OG0001302	0	0	0	1	0	8	9
NONE	OG0001303	0	0	0	0	9	0	9
NONE	OG0001304	0	0	0	0	9	0	9
NONE	OG0001305	0	0	0	0	9	0	9
NONE	OG0001306	2	1	2	1	1	1	8
NONE	OG0001307	1	1	3	1	1	1	8
NONE	OG0001308	1	0	7	0	0	0	8
NONE	OG0001309	4	0	1	0	3	0	8
NONE	OG0001310	2	2	1	1	1	1	8
NONE	OG0001311	2	0	1	1	0	4	8
NONE	OG0001312	1	1	1	1	3	1	8
NONE	OG0001313	4	0	1	0	0	3	8
NONE	OG0001314	2	1	3	1	0	1	8
NONE	OG0001315	2	0	3	1	1	1	8
NONE	OG0001316	3	0	2	2	0	1	8
NONE	OG0001317	1	0	1	6	0	0	8
NONE	OG0001318	2	1	2	1	1	1	8
NONE	OG0001319	2	0	5	0	0	1	8
NONE	OG0001320	2	0	2	1	0	3	8
NONE	OG0001321	2	1	1	1	2	1	8
NONE	OG0001322	2	0	5	0	0	1	8
NONE	OG0001323	6	0	2	0	0	0	8
NONE	OG0001324	3	1	1	1	1	1	8
NONE	OG0001325	1	1	3	1	1	1	8
NONE	OG0001326	1	1	2	1	1	2	8
NONE	OG0001327	1	1	2	1	2	1	8
NONE	OG0001328	1	1	3	1	1	1	8
NONE	OG0001329	1	1	3	1	1	1	8
NONE	OG0001330	1	0	7	0	0	0	8
NONE	OG0001331	1	0	1	4	1	1	8
NONE	OG0001332	2	0	3	1	1	1	8
NONE	OG0001333	1	1	3	1	1	1	8
NONE	OG0001334	1	1	3	1	1	1	8
NONE	OG0001335	1	1	3	1	1	1	8
NONE	OG0001336	1	1	3	1	1	1	8
NONE	OG0001337	1	0	3	1	2	1	8
NONE	OG0001338	1	1	3	1	1	1	8
NONE	OG0001339	8	0	0	0	0	0	8
NONE	OG0001340	1	2	1	1	2	1	8
NONE	OG0001341	2	1	2	1	1	1	8
NONE	OG0001342	6	0	2	0	0	0	8
NONE	OG0001343	2	1	1	2	0	2	8
NONE	OG0001344	2	1	2	1	1	1	8
NONE	OG0001345	1	2	1	3	0	1	8
NONE	OG0001346	1	1	3	1	1	1	8
NONE	OG0001347	1	1	2	2	1	1	8
NONE	OG0001348	1	1	3	1	1	1	8
NONE	OG0001349	1	0	1	1	4	1	8
NONE	OG0001350	2	1	1	2	1	1	8
NONE	OG0001351	3	0	1	3	0	1	8
NONE	OG0001352	2	1	1	1	2	1	8
NONE	OG0001353	1	1	2	2	1	1	8
NONE	OG0001354	2	0	2	2	0	2	8
NONE	OG0001355	1	1	1	2	2	1	8
NONE	OG0001356	2	1	1	2	1	1	8
NONE	OG0001357	3	0	3	1	0	1	8
NONE	OG0001358	2	1	1	1	2	1	8
NONE	OG0001359	1	1	1	1	3	1	8
NONE	OG0001360	3	0	2	0	0	3	8
NONE	OG0001361	1	1	1	3	1	1	8
NONE	OG0001362	3	1	1	2	0	1	8
NONE	OG0001363	1	0	2	4	0	1	8
NONE	OG0001364	1	0	1	4	1	1	8
NONE	OG0001365	1	1	2	1	2	1	8
NONE	OG0001366	3	0	3	0	0	2	8
NONE	OG0001367	2	1	1	1	1	2	8
NONE	OG0001368	2	1	2	1	1	1	8
NONE	OG0001369	2	0	2	2	0	2	8
NONE	OG0001370	1	1	3	1	1	1	8
NONE	OG0001371	2	1	1	2	1	1	8
NONE	OG0001372	2	1	1	1	1	2	8
NONE	OG0001373	2	1	1	1	1	2	8
NONE	OG0001374	8	0	0	0	0	0	8
NONE	OG0001375	2	1	1	1	1	2	8
NONE	OG0001376	1	1	2	1	2	1	8
NONE	OG0001377	4	1	1	1	1	0	8
NONE	OG0001378	2	1	1	2	1	1	8
NONE	OG0001379	8	0	0	0	0	0	8
NONE	OG0001380	8	0	0	0	0	0	8
NONE	OG0001381	1	0	5	0	0	2	8
NONE	OG0001382	3	1	1	1	1	1	8
NONE	OG0001383	2	1	2	2	0	1	8
NONE	OG0001384	6	0	0	0	0	2	8
NONE	OG0001385	2	2	1	1	1	1	8
NONE	OG0001386	1	1	3	1	1	1	8
NONE	OG0001387	3	1	1	1	1	1	8
NONE	OG0001388	5	0	2	1	0	0	8
NONE	OG0001389	4	0	1	0	0	3	8
NONE	OG0001390	6	0	2	0	0	0	8
NONE	OG0001391	1	1	1	1	3	1	8
NONE	OG0001392	6	0	0	0	0	2	8
NONE	OG0001393	1	2	1	1	2	1	8
NONE	OG0001394	8	0	0	0	0	0	8
NONE	OG0001395	1	0	7	0	0	0	8
NONE	OG0001396	1	1	1	2	2	1	8
NONE	OG0001397	7	0	1	0	0	0	8
NONE	OG0001398	3	0	2	1	0	2	8
NONE	OG0001399	1	1	1	2	1	2	8
NONE	OG0001400	1	1	2	1	2	1	8
NONE	OG0001401	1	0	2	3	0	2	8
NONE	OG0001402	2	0	2	2	1	1	8
NONE	OG0001403	1	1	1	4	0	1	8
NONE	OG0001404	3	0	2	1	1	1	8
NONE	OG0001405	6	0	2	0	0	0	8
NONE	OG0001406	3	0	3	0	0	2	8
NONE	OG0001407	1	1	2	1	2	1	8
NONE	OG0001408	3	0	1	1	1	2	8
NONE	OG0001409	1	1	1	2	2	1	8
NONE	OG0001410	1	2	1	2	1	1	8
NONE	OG0001411	6	0	2	0	0	0	8
NONE	OG0001412	2	0	2	1	1	2	8
NONE	OG0001413	1	1	3	1	1	1	8
NONE	OG0001414	2	0	2	3	0	1	8
NONE	OG0001415	2	1	2	1	1	1	8
NONE	OG0001416	3	2	2	1	0	0	8
NONE	OG0001417	8	0	0	0	0	0	8
NONE	OG0001418	1	2	2	1	1	1	8
NONE	OG0001419	1	1	1	3	1	1	8
NONE	OG0001420	1	1	2	2	1	1	8
NONE	OG0001421	1	2	2	1	1	1	8
NONE	OG0001422	1	1	2	2	1	1	8
NONE	OG0001423	7	0	0	1	0	0	8
NONE	OG0001424	5	0	1	1	0	1	8
NONE	OG0001425	7	0	0	0	0	1	8
NONE	OG0001426	1	1	1	1	3	1	8
NONE	OG0001427	5	0	3	0	0	0	8
NONE	OG0001428	1	2	1	1	0	3	8
NONE	OG0001429	1	0	4	2	0	1	8
NONE	OG0001430	2	1	2	2	0	1	8
NONE	OG0001431	1	1	2	2	1	1	8
NONE	OG0001432	4	0	1	0	0	3	8
NONE	OG0001433	1	1	1	2	2	1	8
NONE	OG0001434	2	1	1	2	1	1	8
NONE	OG0001435	2	1	2	1	1	1	8
NONE	OG0001436	2	0	2	2	1	1	8
NONE	OG0001437	1	1	3	1	1	1	8
NONE	OG0001438	2	1	1	1	1	2	8
NONE	OG0001439	2	0	2	1	2	1	8
NONE	OG0001440	1	1	2	2	1	1	8
NONE	OG0001441	1	2	2	1	1	1	8
NONE	OG0001442	4	0	0	0	0	4	8
NONE	OG0001443	7	0	1	0	0	0	8
NONE	OG0001444	1	1	3	1	1	1	8
NONE	OG0001445	1	1	1	0	4	1	8
NONE	OG0001446	2	1	1	1	2	1	8
NONE	OG0001447	2	1	1	1	2	1	8
NONE	OG0001448	1	1	1	3	1	1	8
NONE	OG0001449	1	1	1	2	2	1	8
NONE	OG0001450	1	2	3	1	1	0	8
NONE	OG0001451	2	1	2	1	1	1	8
NONE	OG0001452	2	1	1	2	1	1	8
NONE	OG0001453	1	2	1	2	1	1	8
NONE	OG0001454	1	1	1	2	2	1	8
NONE	OG0001455	1	2	1	3	0	1	8
NONE	OG0001456	2	0	2	2	0	2	8
NONE	OG0001457	1	0	2	3	1	1	8
NONE	OG0001458	2	0	2	1	2	1	8
NONE	OG0001459	2	1	1	1	1	2	8
NONE	OG0001460	2	0	3	1	2	0	8
NONE	OG0001461	6	0	1	0	0	1	8
NONE	OG0001462	3	1	1	2	0	1	8
NONE	OG0001463	1	0	4	1	0	2	8
NONE	OG0001464	3	0	2	0	0	3	8
NONE	OG0001465	1	2	2	2	0	1	8
NONE	OG0001466	1	0	2	4	0	1	8
NONE	OG0001467	3	0	3	1	0	1	8
NONE	OG0001468	1	0	3	0	2	2	8
NONE	OG0001469	2	1	1	2	1	1	8
NONE	OG0001470	2	1	1	2	1	1	8
NONE	OG0001471	2	1	1	2	1	1	8
NONE	OG0001472	2	1	2	1	1	1	8
NONE	OG0001473	2	0	0	0	0	6	8
NONE	OG0001474	1	1	1	3	1	1	8
NONE	OG0001475	2	1	1	1	2	1	8
NONE	OG0001476	2	2	1	1	1	1	8
NONE	OG0001477	1	1	2	2	1	1	8
NONE	OG0001478	1	1	3	1	1	1	8
NONE	OG0001479	3	0	4	0	0	1	8
NONE	OG0001480	3	0	2	3	0	0	8
NONE	OG0001481	2	1	1	1	2	1	8
NONE	OG0001482	2	1	1	1	2	1	8
NONE	OG0001483	1	1	2	1	2	1	8
NONE	OG0001484	1	0	2	2	1	2	8
NONE	OG0001485	2	1	1	1	2	1	8
NONE	OG0001486	5	0	3	0	0	0	8
NONE	OG0001487	1	0	7	0	0	0	8
NONE	OG0001488	6	0	1	1	0	0	8
NONE	OG0001489	2	1	1	2	1	1	8
NONE	OG0001490	1	0	2	0	0	5	8
NONE	OG0001491	1	0	1	5	0	1	8
NONE	OG0001492	1	1	3	1	1	1	8
NONE	OG0001493	1	1	3	1	1	1	8
NONE	OG0001494	1	1	3	1	1	1	8
NONE	OG0001495	1	1	1	3	1	1	8
NONE	OG0001496	1	2	1	2	1	1	8
NONE	OG0001497	1	0	1	1	4	1	8
NONE	OG0001498	2	1	2	1	1	1	8
NONE	OG0001499	1	1	3	1	1	1	8
NONE	OG0001500	1	1	3	1	1	1	8
NONE	OG0001501	1	1	3	1	1	1	8
NONE	OG0001502	1	1	3	1	1	1	8
NONE	OG0001503	1	1	3	1	1	1	8
NONE	OG0001504	1	1	3	1	1	1	8
NONE	OG0001505	1	1	3	1	1	1	8
NONE	OG0001506	1	1	3	1	1	1	8
NONE	OG0001507	1	1	3	1	1	1	8
NONE	OG0001508	2	0	5	0	0	1	8
NONE	OG0001509	1	1	3	1	1	1	8
NONE	OG0001510	1	1	3	1	1	1	8
NONE	OG0001511	1	1	3	1	1	1	8
NONE	OG0001512	1	1	3	1	1	1	8
NONE	OG0001513	1	1	2	3	0	1	8
NONE	OG0001514	1	2	2	1	1	1	8
NONE	OG0001515	1	0	4	1	1	1	8
NONE	OG0001516	1	2	1	2	0	2	8
NONE	OG0001517	1	1	3	1	1	1	8
NONE	OG0001518	1	1	3	1	1	1	8
NONE	OG0001519	2	1	1	1	2	1	8
NONE	OG0001520	2	1	3	1	0	1	8
NONE	OG0001521	2	2	1	1	1	1	8
NONE	OG0001522	2	1	1	1	2	1	8
NONE	OG0001523	1	0	1	0	0	6	8
NONE	OG0001524	1	2	2	1	1	1	8
NONE	OG0001525	2	1	2	1	1	1	8
NONE	OG0001526	1	1	1	3	1	1	8
NONE	OG0001527	1	0	5	0	1	1	8
NONE	OG0001528	3	1	1	0	2	1	8
NONE	OG0001529	2	1	2	1	1	1	8
NONE	OG0001530	5	0	1	0	0	2	8
NONE	OG0001531	1	1	3	1	1	1	8
NONE	OG0001532	2	1	2	1	1	1	8
NONE	OG0001533	2	1	1	1	2	1	8
NONE	OG0001534	2	2	1	1	1	1	8
NONE	OG0001535	1	3	1	1	1	1	8
NONE	OG0001536	2	1	1	2	1	1	8
NONE	OG0001537	2	0	2	2	0	2	8
NONE	OG0001538	2	0	2	3	0	1	8
NONE	OG0001539	2	1	1	2	0	2	8
NONE	OG0001540	2	1	2	1	1	1	8
NONE	OG0001541	3	1	1	1	1	1	8
NONE	OG0001542	1	1	1	1	1	3	8
NONE	OG0001543	8	0	0	0	0	0	8
NONE	OG0001544	2	1	2	1	1	1	8
NONE	OG0001545	2	1	1	1	1	2	8
NONE	OG0001546	1	1	3	1	1	1	8
NONE	OG0001547	1	1	3	1	1	1	8
NONE	OG0001548	1	1	3	1	1	1	8
NONE	OG0001549	1	1	2	1	2	1	8
NONE	OG0001550	1	1	3	1	1	1	8
NONE	OG0001551	1	0	4	2	0	1	8
NONE	OG0001552	2	2	1	1	1	1	8
NONE	OG0001553	4	0	4	0	0	0	8
NONE	OG0001554	1	1	2	2	1	1	8
NONE	OG0001555	3	0	1	0	0	4	8
NONE	OG0001556	2	1	1	2	1	1	8
NONE	OG0001557	2	1	1	2	1	1	8
NONE	OG0001558	2	1	2	1	1	1	8
NONE	OG0001559	1	1	3	1	1	1	8
NONE	OG0001560	2	1	1	1	1	2	8
NONE	OG0001561	2	1	1	0	3	1	8
NONE	OG0001562	1	1	1	2	2	1	8
NONE	OG0001563	2	1	2	1	1	1	8
NONE	OG0001564	2	1	2	1	1	1	8
NONE	OG0001565	1	2	2	3	0	0	8
NONE	OG0001566	2	1	2	1	1	1	8
NONE	OG0001567	1	1	1	1	2	2	8
NONE	OG0001568	3	1	1	1	1	1	8
NONE	OG0001569	1	1	1	2	2	1	8
NONE	OG0001570	2	0	2	3	0	1	8
NONE	OG0001571	2	1	2	1	1	1	8
NONE	OG0001572	1	1	1	3	1	1	8
NONE	OG0001573	2	0	2	3	0	1	8
NONE	OG0001574	1	3	1	1	1	1	8
NONE	OG0001575	2	2	1	1	1	1	8
NONE	OG0001576	2	1	1	2	1	1	8
NONE	OG0001577	2	1	2	1	1	1	8
NONE	OG0001578	1	1	3	1	1	1	8
NONE	OG0001579	3	0	3	1	0	1	8
NONE	OG0001580	1	2	1	1	2	1	8
NONE	OG0001581	1	1	2	2	1	1	8
NONE	OG0001582	3	0	5	0	0	0	8
NONE	OG0001583	1	1	1	1	3	1	8
NONE	OG0001584	1	1	1	2	2	1	8
NONE	OG0001585	1	1	2	2	1	1	8
NONE	OG0001586	1	1	2	2	1	1	8
NONE	OG0001587	1	1	2	2	1	1	8
NONE	OG0001588	1	1	2	2	1	1	8
NONE	OG0001589	2	1	2	1	1	1	8
NONE	OG0001590	1	0	4	1	1	1	8
NONE	OG0001591	1	2	1	1	2	1	8
NONE	OG0001592	3	0	3	0	0	2	8
NONE	OG0001593	1	1	2	2	0	2	8
NONE	OG0001594	2	1	2	1	1	1	8
NONE	OG0001595	1	1	2	2	1	1	8
NONE	OG0001596	2	1	2	1	1	1	8
NONE	OG0001597	4	0	2	0	0	2	8
NONE	OG0001598	1	2	1	2	1	1	8
NONE	OG0001599	1	1	2	2	1	1	8
NONE	OG0001600	1	1	2	2	1	1	8
NONE	OG0001601	1	0	6	1	0	0	8
NONE	OG0001602	2	1	1	1	2	1	8
NONE	OG0001603	1	1	3	1	1	1	8
NONE	OG0001604	1	1	1	2	1	2	8
NONE	OG0001605	2	1	1	2	1	1	8
NONE	OG0001606	2	1	1	2	1	1	8
NONE	OG0001607	2	1	2	1	0	2	8
NONE	OG0001608	1	1	3	1	1	1	8
NONE	OG0001609	1	1	3	1	1	1	8
NONE	OG0001610	2	1	1	1	1	2	8
NONE	OG0001611	1	1	1	3	1	1	8
NONE	OG0001612	1	1	1	3	1	1	8
NONE	OG0001613	1	0	2	0	5	0	8
NONE	OG0001614	2	2	2	1	0	1	8
NONE	OG0001615	1	1	3	1	1	1	8
NONE	OG0001616	1	1	3	1	1	1	8
NONE	OG0001617	1	1	3	1	1	1	8
NONE	OG0001618	1	1	3	1	1	1	8
NONE	OG0001619	1	1	3	1	1	1	8
NONE	OG0001620	1	1	4	0	0	2	8
NONE	OG0001621	2	1	2	1	1	1	8
NONE	OG0001622	1	1	3	1	1	1	8
NONE	OG0001623	1	1	3	1	1	1	8
NONE	OG0001624	1	1	3	1	1	1	8
NONE	OG0001625	1	1	3	1	1	1	8
NONE	OG0001626	1	1	3	1	1	1	8
NONE	OG0001627	2	1	1	2	1	1	8
NONE	OG0001628	1	1	3	1	1	1	8
NONE	OG0001629	1	2	0	2	1	2	8
NONE	OG0001630	3	1	1	1	1	1	8
NONE	OG0001631	2	1	2	2	0	1	8
NONE	OG0001632	2	1	2	1	1	1	8
NONE	OG0001633	1	2	2	2	0	1	8
NONE	OG0001634	8	0	0	0	0	0	8
NONE	OG0001635	2	2	1	1	1	1	8
NONE	OG0001636	2	0	4	0	0	2	8
NONE	OG0001637	2	1	1	2	1	1	8
NONE	OG0001638	1	1	1	1	2	2	8
NONE	OG0001639	1	0	0	0	0	7	8
NONE	OG0001640	1	3	1	1	1	1	8
NONE	OG0001641	1	1	3	1	1	1	8
NONE	OG0001642	3	0	1	3	0	1	8
NONE	OG0001643	3	0	2	2	0	1	8
NONE	OG0001644	2	0	3	1	1	1	8
NONE	OG0001645	3	1	1	1	1	1	8
NONE	OG0001646	2	1	1	2	1	1	8
NONE	OG0001647	1	2	2	2	0	1	8
NONE	OG0001648	3	1	1	1	1	1	8
NONE	OG0001649	2	1	1	2	1	1	8
NONE	OG0001650	1	1	3	1	1	1	8
NONE	OG0001651	2	1	1	2	1	1	8
NONE	OG0001652	1	1	3	1	1	1	8
NONE	OG0001653	2	2	1	1	1	1	8
NONE	OG0001654	1	1	1	2	2	1	8
NONE	OG0001655	1	1	2	2	1	1	8
NONE	OG0001656	1	0	4	2	0	1	8
NONE	OG0001657	2	1	1	1	2	1	8
NONE	OG0001658	1	1	1	2	2	1	8
NONE	OG0001659	5	1	2	0	0	0	8
NONE	OG0001660	7	0	1	0	0	0	8
NONE	OG0001661	1	1	2	2	1	1	8
NONE	OG0001662	2	1	2	1	0	2	8
NONE	OG0001663	3	0	1	4	0	0	8
NONE	OG0001664	2	1	1	2	1	1	8
NONE	OG0001665	2	1	1	2	1	1	8
NONE	OG0001666	1	1	1	2	2	1	8
NONE	OG0001667	1	0	3	3	0	1	8
NONE	OG0001668	1	1	1	3	1	1	8
NONE	OG0001669	1	1	1	2	2	1	8
NONE	OG0001670	3	0	3	1	0	1	8
NONE	OG0001671	2	0	4	0	1	1	8
NONE	OG0001672	2	0	1	4	0	1	8
NONE	OG0001673	2	1	1	2	1	1	8
NONE	OG0001674	3	1	1	1	1	1	8
NONE	OG0001675	1	1	2	2	1	1	8
NONE	OG0001676	1	1	1	4	0	1	8
NONE	OG0001677	1	2	2	2	0	1	8
NONE	OG0001678	1	1	1	2	2	1	8
NONE	OG0001679	3	0	4	1	0	0	8
NONE	OG0001680	2	1	2	1	1	1	8
NONE	OG0001681	1	1	3	1	1	1	8
NONE	OG0001682	1	1	3	1	1	1	8
NONE	OG0001683	2	0	1	4	0	1	8
NONE	OG0001684	1	1	2	3	0	1	8
NONE	OG0001685	3	1	2	1	0	1	8
NONE	OG0001686	3	1	2	1	0	1	8
NONE	OG0001687	2	2	1	1	1	1	8
NONE	OG0001688	1	1	1	1	2	2	8
NONE	OG0001689	1	0	1	5	0	1	8
NONE	OG0001690	1	0	5	0	0	2	8
NONE	OG0001691	2	0	1	1	2	2	8
NONE	OG0001692	2	1	1	2	1	1	8
NONE	OG0001693	2	1	1	2	1	1	8
NONE	OG0001694	8	0	0	0	0	0	8
NONE	OG0001695	2	1	2	0	1	2	8
NONE	OG0001696	1	1	1	3	1	1	8
NONE	OG0001697	1	3	1	1	1	1	8
NONE	OG0001698	2	1	2	1	1	1	8
NONE	OG0001699	5	0	1	1	0	1	8
NONE	OG0001700	1	1	3	1	1	1	8
NONE	OG0001701	1	2	1	1	1	2	8
NONE	OG0001702	1	0	0	4	0	3	8
NONE	OG0001703	1	1	1	2	2	1	8
NONE	OG0001704	2	0	3	2	1	0	8
NONE	OG0001705	1	1	1	2	2	1	8
NONE	OG0001706	3	1	1	1	1	1	8
NONE	OG0001707	2	0	3	0	2	1	8
NONE	OG0001708	3	0	2	3	0	0	8
NONE	OG0001709	1	2	2	1	1	1	8
NONE	OG0001710	2	1	2	1	0	2	8
NONE	OG0001711	3	0	1	2	0	2	8
NONE	OG0001712	3	1	1	1	1	1	8
NONE	OG0001713	2	0	2	2	1	1	8
NONE	OG0001714	1	1	1	3	1	1	8
NONE	OG0001715	2	2	1	1	1	1	8
NONE	OG0001716	8	0	0	0	0	0	8
NONE	OG0001717	1	1	2	2	1	1	8
NONE	OG0001718	2	0	2	1	0	3	8
NONE	OG0001719	1	0	4	1	1	1	8
NONE	OG0001720	2	1	2	1	1	1	8
NONE	OG0001721	2	1	2	1	1	1	8
NONE	OG0001722	2	1	1	1	2	1	8
NONE	OG0001723	2	1	1	2	1	1	8
NONE	OG0001724	1	1	1	2	1	2	8
NONE	OG0001725	1	1	1	3	1	1	8
NONE	OG0001726	1	0	7	0	0	0	8
NONE	OG0001727	1	1	1	2	2	1	8
NONE	OG0001728	1	1	1	2	1	2	8
NONE	OG0001729	2	1	2	1	1	1	8
NONE	OG0001730	1	1	1	1	0	4	8
NONE	OG0001731	2	1	1	2	1	1	8
NONE	OG0001732	1	1	1	2	1	2	8
NONE	OG0001733	1	3	1	1	1	1	8
NONE	OG0001734	1	1	3	1	1	1	8
NONE	OG0001735	1	1	2	1	2	1	8
NONE	OG0001736	1	0	4	1	1	1	8
NONE	OG0001737	2	0	1	2	2	1	8
NONE	OG0001738	2	0	2	2	0	2	8
NONE	OG0001739	1	3	1	1	1	1	8
NONE	OG0001740	1	1	1	2	1	2	8
NONE	OG0001741	1	0	4	0	0	3	8
NONE	OG0001742	1	1	2	1	1	2	8
NONE	OG0001743	3	0	1	3	0	1	8
NONE	OG0001744	2	1	2	1	1	1	8
NONE	OG0001745	1	1	1	3	1	1	8
NONE	OG0001746	2	1	1	2	1	1	8
NONE	OG0001747	2	2	1	1	1	1	8
NONE	OG0001748	2	0	0	5	0	1	8
NONE	OG0001749	1	1	2	4	0	0	8
NONE	OG0001750	1	1	3	1	1	1	8
NONE	OG0001751	1	2	1	2	1	1	8
NONE	OG0001752	1	2	1	2	1	1	8
NONE	OG0001753	2	1	2	2	0	1	8
NONE	OG0001754	2	0	2	2	0	2	8
NONE	OG0001755	1	1	1	1	1	3	8
NONE	OG0001756	1	1	2	1	2	1	8
NONE	OG0001757	1	3	1	1	0	2	8
NONE	OG0001758	1	1	2	2	1	1	8
NONE	OG0001759	1	1	3	1	1	1	8
NONE	OG0001760	1	1	1	3	1	1	8
NONE	OG0001761	1	1	1	1	1	3	8
NONE	OG0001762	2	1	2	1	1	1	8
NONE	OG0001763	1	1	3	1	1	1	8
NONE	OG0001764	1	1	3	1	1	1	8
NONE	OG0001765	1	1	3	1	1	1	8
NONE	OG0001766	1	1	1	1	2	2	8
NONE	OG0001767	2	1	2	1	1	1	8
NONE	OG0001768	1	1	3	1	1	1	8
NONE	OG0001769	1	1	1	1	3	1	8
NONE	OG0001770	2	1	2	1	1	1	8
NONE	OG0001771	2	1	1	2	1	1	8
NONE	OG0001772	3	1	1	1	1	1	8
NONE	OG0001773	2	1	1	1	2	1	8
NONE	OG0001774	1	1	2	2	1	1	8
NONE	OG0001775	1	0	0	0	0	7	8
NONE	OG0001776	2	1	2	1	1	1	8
NONE	OG0001777	2	0	1	5	0	0	8
NONE	OG0001778	4	0	1	0	1	2	8
NONE	OG0001779	1	1	1	1	3	1	8
NONE	OG0001780	2	1	1	2	1	1	8
NONE	OG0001781	1	0	1	4	1	1	8
NONE	OG0001782	2	1	1	2	1	1	8
NONE	OG0001783	2	0	2	3	0	1	8
NONE	OG0001784	2	1	2	1	0	2	8
NONE	OG0001785	1	1	1	1	3	1	8
NONE	OG0001786	1	1	2	2	1	1	8
NONE	OG0001787	3	0	1	1	1	2	8
NONE	OG0001788	3	0	5	0	0	0	8
NONE	OG0001789	1	1	3	1	1	1	8
NONE	OG0001790	1	1	3	1	1	1	8
NONE	OG0001791	1	1	3	1	1	1	8
NONE	OG0001792	1	1	3	1	1	1	8
NONE	OG0001793	1	1	3	1	1	1	8
NONE	OG0001794	1	1	1	2	2	1	8
NONE	OG0001795	1	1	1	3	1	1	8
NONE	OG0001796	1	3	1	2	0	1	8
NONE	OG0001797	1	1	1	3	1	1	8
NONE	OG0001798	1	1	3	1	1	1	8
NONE	OG0001799	1	1	3	1	1	1	8
NONE	OG0001800	1	1	3	1	1	1	8
NONE	OG0001801	1	1	3	1	1	1	8
NONE	OG0001802	1	1	3	1	1	1	8
NONE	OG0001803	1	1	3	1	0	2	8
NONE	OG0001804	1	1	3	1	1	1	8
NONE	OG0001805	1	1	3	1	1	1	8
NONE	OG0001806	1	1	3	1	1	1	8
NONE	OG0001807	1	1	3	1	1	1	8
NONE	OG0001808	1	1	3	1	1	1	8
NONE	OG0001809	2	1	1	1	2	1	8
NONE	OG0001810	2	0	1	4	0	1	8
NONE	OG0001811	1	1	1	3	1	1	8
NONE	OG0001812	2	2	1	1	0	2	8
NONE	OG0001813	1	1	1	1	3	1	8
NONE	OG0001814	1	1	3	1	1	1	8
NONE	OG0001815	0	7	0	1	0	0	8
NONE	OG0001816	0	1	0	7	0	0	8
NONE	OG0001817	0	1	2	3	1	1	8
NONE	OG0001818	0	0	5	1	0	2	8
NONE	OG0001819	0	0	8	0	0	0	8
NONE	OG0001820	0	0	4	0	0	4	8
NONE	OG0001821	0	0	8	0	0	0	8
NONE	OG0001822	0	0	8	0	0	0	8
NONE	OG0001823	0	0	4	0	0	4	8
NONE	OG0001824	0	0	8	0	0	0	8
NONE	OG0001825	0	0	1	2	0	5	8
NONE	OG0001826	0	0	8	0	0	0	8
NONE	OG0001827	0	0	8	0	0	0	8
NONE	OG0001828	0	0	4	0	0	4	8
NONE	OG0001829	0	0	8	0	0	0	8
NONE	OG0001830	0	0	8	0	0	0	8
NONE	OG0001831	0	0	4	0	0	4	8
NONE	OG0001832	0	0	2	0	0	6	8
NONE	OG0001833	0	0	7	0	0	1	8
NONE	OG0001834	0	0	1	0	0	7	8
NONE	OG0001835	0	0	2	1	0	5	8
NONE	OG0001836	0	0	0	8	0	0	8
NONE	OG0001837	0	0	0	8	0	0	8
NONE	OG0001838	0	0	0	8	0	0	8
NONE	OG0001839	0	0	0	8	0	0	8
NONE	OG0001840	0	0	0	8	0	0	8
NONE	OG0001841	0	0	0	0	8	0	8
NONE	OG0001842	0	0	0	0	8	0	8
NONE	OG0001843	0	0	0	0	8	0	8
NONE	OG0001844	0	0	0	0	8	0	8
NONE	OG0001845	0	0	0	0	8	0	8
NONE	OG0001846	0	0	0	0	8	0	8
NONE	OG0001847	0	0	0	0	1	7	8
NONE	OG0001848	0	0	0	0	8	0	8
NONE	OG0001849	0	0	0	0	0	8	8
NONE	OG0001850	0	0	0	0	0	8	8
NONE	OG0001851	2	1	1	1	1	1	7
NONE	OG0001852	2	0	1	1	0	3	7
NONE	OG0001853	1	1	1	2	1	1	7
NONE	OG0001854	2	1	1	1	1	1	7
NONE	OG0001855	4	0	3	0	0	0	7
NONE	OG0001856	1	1	2	1	1	1	7
NONE	OG0001857	2	1	1	1	1	1	7
NONE	OG0001858	1	1	2	2	0	1	7
NONE	OG0001859	2	1	1	1	1	1	7
NONE	OG0001860	1	1	3	1	0	1	7
NONE	OG0001861	1	1	1	2	1	1	7
NONE	OG0001862	2	1	1	1	1	1	7
NONE	OG0001863	2	1	1	1	1	1	7
NONE	OG0001864	2	1	1	1	1	1	7
NONE	OG0001865	3	0	2	2	0	0	7
NONE	OG0001866	1	1	1	2	1	1	7
NONE	OG0001867	2	1	1	1	1	1	7
NONE	OG0001868	2	1	1	1	1	1	7
NONE	OG0001869	2	1	1	1	1	1	7
NONE	OG0001870	2	1	1	1	1	1	7
NONE	OG0001871	2	0	2	2	0	1	7
NONE	OG0001872	1	1	1	2	1	1	7
NONE	OG0001873	1	1	1	1	2	1	7
NONE	OG0001874	1	1	2	1	1	1	7
NONE	OG0001875	1	1	2	1	1	1	7
NONE	OG0001876	6	0	1	0	0	0	7
NONE	OG0001877	1	1	2	1	1	1	7
NONE	OG0001878	1	1	2	1	1	1	7
NONE	OG0001879	1	1	1	1	2	1	7
NONE	OG0001880	2	1	1	1	1	1	7
NONE	OG0001881	1	1	1	1	2	1	7
NONE	OG0001882	1	1	1	2	1	1	7
NONE	OG0001883	3	0	0	3	0	1	7
NONE	OG0001884	2	1	1	1	1	1	7
NONE	OG0001885	1	1	2	1	1	1	7
NONE	OG0001886	1	1	1	2	1	1	7
NONE	OG0001887	1	1	2	2	0	1	7
NONE	OG0001888	1	1	2	1	0	2	7
NONE	OG0001889	1	1	2	1	1	1	7
NONE	OG0001890	2	1	1	1	1	1	7
NONE	OG0001891	2	1	1	0	1	2	7
NONE	OG0001892	1	1	1	1	2	1	7
NONE	OG0001893	1	1	2	1	1	1	7
NONE	OG0001894	1	1	1	1	2	1	7
NONE	OG0001895	2	1	1	1	1	1	7
NONE	OG0001896	2	1	1	1	1	1	7
NONE	OG0001897	3	0	1	1	1	1	7
NONE	OG0001898	1	1	1	1	1	2	7
NONE	OG0001899	7	0	0	0	0	0	7
NONE	OG0001900	2	1	1	1	1	1	7
NONE	OG0001901	1	1	1	2	1	1	7
NONE	OG0001902	1	1	1	1	2	1	7
NONE	OG0001903	1	1	2	1	1	1	7
NONE	OG0001904	1	1	2	1	1	1	7
NONE	OG0001905	1	2	2	1	0	1	7
NONE	OG0001906	1	1	2	1	1	1	7
NONE	OG0001907	1	1	1	2	1	1	7
NONE	OG0001908	1	1	1	1	1	2	7
NONE	OG0001909	2	1	1	1	1	1	7
NONE	OG0001910	2	1	1	1	1	1	7
NONE	OG0001911	2	1	1	1	1	1	7
NONE	OG0001912	2	1	1	1	1	1	7
NONE	OG0001913	2	1	1	1	1	1	7
NONE	OG0001914	2	1	1	1	1	1	7
NONE	OG0001915	1	1	2	1	1	1	7
NONE	OG0001916	1	1	2	1	1	1	7
NONE	OG0001917	1	1	1	2	1	1	7
NONE	OG0001918	1	1	2	1	1	1	7
NONE	OG0001919	1	0	1	3	1	1	7
NONE	OG0001920	1	2	1	1	1	1	7
NONE	OG0001921	1	0	2	2	1	1	7
NONE	OG0001922	1	1	1	2	1	1	7
NONE	OG0001923	7	0	0	0	0	0	7
NONE	OG0001924	4	0	3	0	0	0	7
NONE	OG0001925	4	0	0	0	0	3	7
NONE	OG0001926	1	1	1	2	1	1	7
NONE	OG0001927	1	1	2	1	1	1	7
NONE	OG0001928	1	1	2	1	1	1	7
NONE	OG0001929	1	1	2	1	1	1	7
NONE	OG0001930	1	1	2	1	1	1	7
NONE	OG0001931	1	1	2	1	1	1	7
NONE	OG0001932	1	1	2	1	1	1	7
NONE	OG0001933	1	1	2	1	1	1	7
NONE	OG0001934	1	1	2	1	1	1	7
NONE	OG0001935	1	1	2	1	1	1	7
NONE	OG0001936	1	0	3	1	1	1	7
NONE	OG0001937	1	0	3	1	1	1	7
NONE	OG0001938	1	1	3	1	0	1	7
NONE	OG0001939	2	1	1	1	1	1	7
NONE	OG0001940	1	1	1	1	2	1	7
NONE	OG0001941	1	1	2	1	1	1	7
NONE	OG0001942	1	0	3	1	1	1	7
NONE	OG0001943	1	1	2	1	1	1	7
NONE	OG0001944	1	1	2	1	1	1	7
NONE	OG0001945	1	0	3	1	1	1	7
NONE	OG0001946	1	1	2	1	1	1	7
NONE	OG0001947	1	1	3	1	0	1	7
NONE	OG0001948	1	1	2	1	1	1	7
NONE	OG0001949	3	0	3	0	0	1	7
NONE	OG0001950	7	0	0	0	0	0	7
NONE	OG0001951	4	0	1	2	0	0	7
NONE	OG0001952	2	1	1	1	1	1	7
NONE	OG0001953	1	2	1	1	1	1	7
NONE	OG0001954	1	1	2	1	1	1	7
NONE	OG0001955	2	1	1	1	1	1	7
NONE	OG0001956	1	1	1	1	2	1	7
NONE	OG0001957	1	2	1	1	1	1	7
NONE	OG0001958	1	0	0	3	2	1	7
NONE	OG0001959	2	0	2	1	1	1	7
NONE	OG0001960	1	1	1	1	2	1	7
NONE	OG0001961	7	0	0	0	0	0	7
NONE	OG0001962	6	0	1	0	0	0	7
NONE	OG0001963	4	0	3	0	0	0	7
NONE	OG0001964	1	1	2	1	1	1	7
NONE	OG0001965	1	1	2	1	1	1	7
NONE	OG0001966	1	1	2	1	1	1	7
NONE	OG0001967	1	1	2	1	1	1	7
NONE	OG0001968	1	1	2	1	1	1	7
NONE	OG0001969	7	0	0	0	0	0	7
NONE	OG0001970	1	1	2	1	1	1	7
NONE	OG0001971	2	1	1	1	1	1	7
NONE	OG0001972	2	1	1	1	1	1	7
NONE	OG0001973	3	0	3	0	0	1	7
NONE	OG0001974	1	0	2	0	0	4	7
NONE	OG0001975	5	0	1	0	0	1	7
NONE	OG0001976	7	0	0	0	0	0	7
NONE	OG0001977	1	1	1	2	1	1	7
NONE	OG0001978	1	1	1	2	1	1	7
NONE	OG0001979	1	1	1	2	1	1	7
NONE	OG0001980	2	1	1	1	1	1	7
NONE	OG0001981	2	1	1	1	1	1	7
NONE	OG0001982	2	1	1	1	1	1	7
NONE	OG0001983	3	0	1	1	1	1	7
NONE	OG0001984	2	1	1	1	1	1	7
NONE	OG0001985	2	1	1	1	1	1	7
NONE	OG0001986	7	0	0	0	0	0	7
NONE	OG0001987	2	1	1	1	1	1	7
NONE	OG0001988	2	1	1	1	1	1	7
NONE	OG0001989	2	1	1	1	1	1	7
NONE	OG0001990	2	1	1	1	1	1	7
NONE	OG0001991	2	1	1	1	1	1	7
NONE	OG0001992	2	1	1	1	1	1	7
NONE	OG0001993	2	1	1	1	1	1	7
NONE	OG0001994	2	1	1	1	1	1	7
NONE	OG0001995	2	0	3	1	0	1	7
NONE	OG0001996	5	0	2	0	0	0	7
NONE	OG0001997	1	1	2	1	1	1	7
NONE	OG0001998	1	1	2	1	1	1	7
NONE	OG0001999	1	1	1	2	1	1	7
NONE	OG0002000	1	1	1	2	1	1	7
NONE	OG0002001	1	1	1	2	1	1	7
NONE	OG0002002	1	1	1	2	1	1	7
NONE	OG0002003	1	1	1	2	1	1	7
NONE	OG0002004	1	1	1	2	1	1	7
NONE	OG0002005	1	1	1	1	2	1	7
NONE	OG0002006	1	1	1	2	1	1	7
NONE	OG0002007	1	1	1	1	1	2	7
NONE	OG0002008	7	0	0	0	0	0	7
NONE	OG0002009	1	1	2	1	1	1	7
NONE	OG0002010	1	1	2	1	1	1	7
NONE	OG0002011	1	1	2	1	1	1	7
NONE	OG0002012	1	1	2	1	1	1	7
NONE	OG0002013	1	1	2	1	1	1	7
NONE	OG0002014	1	1	2	1	1	1	7
NONE	OG0002015	1	1	2	1	1	1	7
NONE	OG0002016	1	1	1	1	2	1	7
NONE	OG0002017	4	0	3	0	0	0	7
NONE	OG0002018	1	1	1	2	1	1	7
NONE	OG0002019	1	0	1	4	0	1	7
NONE	OG0002020	1	1	1	2	1	1	7
NONE	OG0002021	1	1	1	2	1	1	7
NONE	OG0002022	1	1	1	2	1	1	7
NONE	OG0002023	1	1	1	2	1	1	7
NONE	OG0002024	1	1	1	2	1	1	7
NONE	OG0002025	2	1	2	0	0	2	7
NONE	OG0002026	3	1	1	1	0	1	7
NONE	OG0002027	2	0	3	1	0	1	7
NONE	OG0002028	2	1	1	1	1	1	7
NONE	OG0002029	3	0	3	0	0	1	7
NONE	OG0002030	1	1	1	1	2	1	7
NONE	OG0002031	1	1	1	1	2	1	7
NONE	OG0002032	1	1	1	2	1	1	7
NONE	OG0002033	1	1	1	2	1	1	7
NONE	OG0002034	1	1	1	2	1	1	7
NONE	OG0002035	1	1	1	1	2	1	7
NONE	OG0002036	2	0	3	0	0	2	7
NONE	OG0002037	1	1	1	2	1	1	7
NONE	OG0002038	3	0	4	0	0	0	7
NONE	OG0002039	1	2	1	1	1	1	7
NONE	OG0002040	2	0	2	2	0	1	7
NONE	OG0002041	1	0	1	3	0	2	7
NONE	OG0002042	1	1	1	2	1	1	7
NONE	OG0002043	5	0	1	1	0	0	7
NONE	OG0002044	1	2	1	1	1	1	7
NONE	OG0002045	1	0	0	5	0	1	7
NONE	OG0002046	1	1	1	1	2	1	7
NONE	OG0002047	1	0	2	3	0	1	7
NONE	OG0002048	1	1	1	2	1	1	7
NONE	OG0002049	2	1	1	1	1	1	7
NONE	OG0002050	2	1	1	1	1	1	7
NONE	OG0002051	2	1	1	1	1	1	7
NONE	OG0002052	2	1	1	1	1	1	7
NONE	OG0002053	2	1	1	1	1	1	7
NONE	OG0002054	3	0	1	1	1	1	7
NONE	OG0002055	2	1	1	1	1	1	7
NONE	OG0002056	1	1	3	1	0	1	7
NONE	OG0002057	1	1	2	1	1	1	7
NONE	OG0002058	1	1	2	1	1	1	7
NONE	OG0002059	1	1	1	1	2	1	7
NONE	OG0002060	1	1	1	2	1	1	7
NONE	OG0002061	2	0	0	0	0	5	7
NONE	OG0002062	1	1	2	1	1	1	7
NONE	OG0002063	1	1	3	1	0	1	7
NONE	OG0002064	1	0	4	2	0	0	7
NONE	OG0002065	1	0	3	2	0	1	7
NONE	OG0002066	1	1	1	2	1	1	7
NONE	OG0002067	1	1	1	2	1	1	7
NONE	OG0002068	1	1	1	2	1	1	7
NONE	OG0002069	1	1	1	2	1	1	7
NONE	OG0002070	1	1	1	2	1	1	7
NONE	OG0002071	1	1	1	2	1	1	7
NONE	OG0002072	1	1	1	2	1	1	7
NONE	OG0002073	1	1	1	2	1	1	7
NONE	OG0002074	1	1	1	2	1	1	7
NONE	OG0002075	1	1	1	2	1	1	7
NONE	OG0002076	1	1	1	2	1	1	7
NONE	OG0002077	1	1	2	1	1	1	7
NONE	OG0002078	1	1	2	1	1	1	7
NONE	OG0002079	1	1	2	1	1	1	7
NONE	OG0002080	2	1	1	1	1	1	7
NONE	OG0002081	1	1	1	1	2	1	7
NONE	OG0002082	1	1	1	2	1	1	7
NONE	OG0002083	1	1	1	1	1	2	7
NONE	OG0002084	1	1	1	2	1	1	7
NONE	OG0002085	2	1	1	1	1	1	7
NONE	OG0002086	2	1	1	1	1	1	7
NONE	OG0002087	2	1	1	1	1	1	7
NONE	OG0002088	2	1	1	1	1	1	7
NONE	OG0002089	1	0	2	2	1	1	7
NONE	OG0002090	1	1	2	1	1	1	7
NONE	OG0002091	1	1	2	1	1	1	7
NONE	OG0002092	1	1	2	1	1	1	7
NONE	OG0002093	1	1	2	1	1	1	7
NONE	OG0002094	1	1	2	1	1	1	7
NONE	OG0002095	1	1	2	1	1	1	7
NONE	OG0002096	1	1	2	1	1	1	7
NONE	OG0002097	2	0	2	1	1	1	7
NONE	OG0002098	1	1	2	1	1	1	7
NONE	OG0002099	1	1	2	1	1	1	7
NONE	OG0002100	1	1	2	1	1	1	7
NONE	OG0002101	4	0	2	0	0	1	7
NONE	OG0002102	1	2	1	1	1	1	7
NONE	OG0002103	1	1	1	1	1	2	7
NONE	OG0002104	7	0	0	0	0	0	7
NONE	OG0002105	1	1	1	1	2	1	7
NONE	OG0002106	2	1	1	1	1	1	7
NONE	OG0002107	2	1	1	1	1	1	7
NONE	OG0002108	1	2	1	1	1	1	7
NONE	OG0002109	1	0	3	1	1	1	7
NONE	OG0002110	1	1	1	2	1	1	7
NONE	OG0002111	2	1	1	1	1	1	7
NONE	OG0002112	2	1	1	1	1	1	7
NONE	OG0002113	2	1	1	1	1	1	7
NONE	OG0002114	2	1	1	1	1	1	7
NONE	OG0002115	1	1	1	1	2	1	7
NONE	OG0002116	2	1	1	1	1	1	7
NONE	OG0002117	2	1	1	2	0	1	7
NONE	OG0002118	1	1	1	2	1	1	7
NONE	OG0002119	1	1	1	1	1	2	7
NONE	OG0002120	2	1	1	1	1	1	7
NONE	OG0002121	2	1	1	1	1	1	7
NONE	OG0002122	2	1	1	1	1	1	7
NONE	OG0002123	2	1	1	2	0	1	7
NONE	OG0002124	2	1	1	1	1	1	7
NONE	OG0002125	2	1	1	1	1	1	7
NONE	OG0002126	2	1	1	1	1	1	7
NONE	OG0002127	1	0	1	1	1	3	7
NONE	OG0002128	1	1	2	1	1	1	7
NONE	OG0002129	2	1	1	1	1	1	7
NONE	OG0002130	2	1	1	1	1	1	7
NONE	OG0002131	3	0	2	1	0	1	7
NONE	OG0002132	2	1	1	1	1	1	7
NONE	OG0002133	2	0	4	0	0	1	7
NONE	OG0002134	4	0	3	0	0	0	7
NONE	OG0002135	2	1	1	1	1	1	7
NONE	OG0002136	2	0	2	1	1	1	7
NONE	OG0002137	1	1	2	1	1	1	7
NONE	OG0002138	2	1	1	1	1	1	7
NONE	OG0002139	4	0	2	0	0	1	7
NONE	OG0002140	5	0	0	2	0	0	7
NONE	OG0002141	1	1	1	2	1	1	7
NONE	OG0002142	1	1	1	2	1	1	7
NONE	OG0002143	1	1	1	1	1	2	7
NONE	OG0002144	1	1	2	1	1	1	7
NONE	OG0002145	1	1	2	1	1	1	7
NONE	OG0002146	1	1	2	1	1	1	7
NONE	OG0002147	1	1	2	1	1	1	7
NONE	OG0002148	1	1	2	1	1	1	7
NONE	OG0002149	1	1	2	1	1	1	7
NONE	OG0002150	1	1	1	2	1	1	7
NONE	OG0002151	2	1	2	1	0	1	7
NONE	OG0002152	5	0	1	0	0	1	7
NONE	OG0002153	1	1	2	1	1	1	7
NONE	OG0002154	1	2	1	1	1	1	7
NONE	OG0002155	1	1	1	1	2	1	7
NONE	OG0002156	2	1	1	1	1	1	7
NONE	OG0002157	1	1	1	1	2	1	7
NONE	OG0002158	3	0	2	1	0	1	7
NONE	OG0002159	2	1	1	1	1	1	7
NONE	OG0002160	3	0	4	0	0	0	7
NONE	OG0002161	1	0	1	4	0	1	7
NONE	OG0002162	2	1	1	1	1	1	7
NONE	OG0002163	1	1	1	2	1	1	7
NONE	OG0002164	1	1	1	1	2	1	7
NONE	OG0002165	2	1	1	1	1	1	7
NONE	OG0002166	1	1	1	2	0	2	7
NONE	OG0002167	1	2	1	1	1	1	7
NONE	OG0002168	2	1	1	1	1	1	7
NONE	OG0002169	1	1	2	1	1	1	7
NONE	OG0002170	1	0	1	1	3	1	7
NONE	OG0002171	1	1	2	1	1	1	7
NONE	OG0002172	2	1	1	1	1	1	7
NONE	OG0002173	1	2	1	1	1	1	7
NONE	OG0002174	1	1	1	2	1	1	7
NONE	OG0002175	2	0	1	3	0	1	7
NONE	OG0002176	3	0	2	0	0	2	7
NONE	OG0002177	1	1	1	2	1	1	7
NONE	OG0002178	1	1	1	2	1	1	7
NONE	OG0002179	1	1	1	2	1	1	7
NONE	OG0002180	1	1	1	2	1	1	7
NONE	OG0002181	1	1	1	2	1	1	7
NONE	OG0002182	1	1	1	2	1	1	7
NONE	OG0002183	1	1	1	2	1	1	7
NONE	OG0002184	1	1	1	2	1	1	7
NONE	OG0002185	1	1	1	2	1	1	7
NONE	OG0002186	1	1	1	2	1	1	7
NONE	OG0002187	1	1	1	2	1	1	7
NONE	OG0002188	1	1	1	2	1	1	7
NONE	OG0002189	1	1	1	1	2	1	7
NONE	OG0002190	1	2	1	1	1	1	7
NONE	OG0002191	1	1	1	0	2	2	7
NONE	OG0002192	6	0	1	0	0	0	7
NONE	OG0002193	2	2	0	1	0	2	7
NONE	OG0002194	1	1	2	1	1	1	7
NONE	OG0002195	1	2	1	1	1	1	7
NONE	OG0002196	2	1	2	0	1	1	7
NONE	OG0002197	4	0	1	1	0	1	7
NONE	OG0002198	7	0	0	0	0	0	7
NONE	OG0002199	4	0	3	0	0	0	7
NONE	OG0002200	1	0	1	0	0	5	7
NONE	OG0002201	1	1	1	2	1	1	7
NONE	OG0002202	5	0	1	0	0	1	7
NONE	OG0002203	2	1	1	1	1	1	7
NONE	OG0002204	1	1	1	2	1	1	7
NONE	OG0002205	2	0	5	0	0	0	7
NONE	OG0002206	1	1	1	2	1	1	7
NONE	OG0002207	1	1	1	2	1	1	7
NONE	OG0002208	1	1	1	2	1	1	7
NONE	OG0002209	1	1	1	2	1	1	7
NONE	OG0002210	3	0	1	2	1	0	7
NONE	OG0002211	1	1	1	1	2	1	7
NONE	OG0002212	1	1	1	2	1	1	7
NONE	OG0002213	1	1	1	1	1	2	7
NONE	OG0002214	2	1	1	1	1	1	7
NONE	OG0002215	2	1	1	1	1	1	7
NONE	OG0002216	1	1	1	2	1	1	7
NONE	OG0002217	1	1	1	2	1	1	7
NONE	OG0002218	2	1	1	1	1	1	7
NONE	OG0002219	1	1	2	1	1	1	7
NONE	OG0002220	1	1	1	1	1	2	7
NONE	OG0002221	5	0	2	0	0	0	7
NONE	OG0002222	2	1	1	1	1	1	7
NONE	OG0002223	2	1	1	1	1	1	7
NONE	OG0002224	1	1	1	1	2	1	7
NONE	OG0002225	2	1	1	1	1	1	7
NONE	OG0002226	1	1	2	1	1	1	7
NONE	OG0002227	1	1	1	1	2	1	7
NONE	OG0002228	1	1	1	1	1	2	7
NONE	OG0002229	2	1	1	1	1	1	7
NONE	OG0002230	2	1	1	2	0	1	7
NONE	OG0002231	2	1	1	1	1	1	7
NONE	OG0002232	1	0	0	0	6	0	7
NONE	OG0002233	2	0	2	0	0	3	7
NONE	OG0002234	2	1	1	1	1	1	7
NONE	OG0002235	3	1	1	1	0	1	7
NONE	OG0002236	3	0	4	0	0	0	7
NONE	OG0002237	2	1	1	1	1	1	7
NONE	OG0002238	2	1	1	1	1	1	7
NONE	OG0002239	1	1	1	1	2	1	7
NONE	OG0002240	7	0	0	0	0	0	7
NONE	OG0002241	1	1	1	1	1	2	7
NONE	OG0002242	4	0	1	1	0	1	7
NONE	OG0002243	1	1	1	2	1	1	7
NONE	OG0002244	1	1	1	2	1	1	7
NONE	OG0002245	1	1	1	2	1	1	7
NONE	OG0002246	5	0	1	0	0	1	7
NONE	OG0002247	1	1	1	2	1	1	7
NONE	OG0002248	1	1	1	2	1	1	7
NONE	OG0002249	1	1	1	2	1	1	7
NONE	OG0002250	1	1	1	2	1	1	7
NONE	OG0002251	2	1	0	1	1	2	7
NONE	OG0002252	1	1	1	1	1	2	7
NONE	OG0002253	1	1	1	2	1	1	7
NONE	OG0002254	1	1	1	2	1	1	7
NONE	OG0002255	2	1	1	1	1	1	7
NONE	OG0002256	2	1	1	1	1	1	7
NONE	OG0002257	1	1	1	2	1	1	7
NONE	OG0002258	2	1	1	1	1	1	7
NONE	OG0002259	1	1	2	1	1	1	7
NONE	OG0002260	1	2	1	1	1	1	7
NONE	OG0002261	2	1	1	1	1	1	7
NONE	OG0002262	1	0	4	1	0	1	7
NONE	OG0002263	2	1	2	1	0	1	7
NONE	OG0002264	1	2	1	1	1	1	7
NONE	OG0002265	1	1	1	2	1	1	7
NONE	OG0002266	2	1	1	1	1	1	7
NONE	OG0002267	1	1	1	2	1	1	7
NONE	OG0002268	2	1	1	1	1	1	7
NONE	OG0002269	1	1	2	1	1	1	7
NONE	OG0002270	7	0	0	0	0	0	7
NONE	OG0002271	1	1	1	1	2	1	7
NONE	OG0002272	2	0	1	4	0	0	7
NONE	OG0002273	1	1	1	2	1	1	7
NONE	OG0002274	1	1	1	2	1	1	7
NONE	OG0002275	1	1	1	2	1	1	7
NONE	OG0002276	1	1	1	2	1	1	7
NONE	OG0002277	1	1	2	1	1	1	7
NONE	OG0002278	1	1	1	1	1	2	7
NONE	OG0002279	1	1	2	1	1	1	7
NONE	OG0002280	1	1	1	1	2	1	7
NONE	OG0002281	1	1	1	2	1	1	7
NONE	OG0002282	1	1	2	1	1	1	7
NONE	OG0002283	2	1	1	2	0	1	7
NONE	OG0002284	2	1	1	1	1	1	7
NONE	OG0002285	2	0	3	2	0	0	7
NONE	OG0002286	7	0	0	0	0	0	7
NONE	OG0002287	2	1	1	1	1	1	7
NONE	OG0002288	1	1	2	1	1	1	7
NONE	OG0002289	1	1	2	1	1	1	7
NONE	OG0002290	1	1	2	1	1	1	7
NONE	OG0002291	1	1	2	1	1	1	7
NONE	OG0002292	1	1	2	1	1	1	7
NONE	OG0002293	2	1	1	1	1	1	7
NONE	OG0002294	2	1	1	1	1	1	7
NONE	OG0002295	3	0	2	1	0	1	7
NONE	OG0002296	1	1	1	1	2	1	7
NONE	OG0002297	2	1	1	1	1	1	7
NONE	OG0002298	2	1	1	1	1	1	7
NONE	OG0002299	2	1	1	1	1	1	7
NONE	OG0002300	2	1	1	1	1	1	7
NONE	OG0002301	1	1	1	1	2	1	7
NONE	OG0002302	2	1	1	1	1	1	7
NONE	OG0002303	2	1	1	1	1	1	7
NONE	OG0002304	1	1	1	2	1	1	7
NONE	OG0002305	1	1	1	2	1	1	7
NONE	OG0002306	3	0	4	0	0	0	7
NONE	OG0002307	1	1	3	1	0	1	7
NONE	OG0002308	2	1	1	1	1	1	7
NONE	OG0002309	2	1	1	1	1	1	7
NONE	OG0002310	1	0	2	4	0	0	7
NONE	OG0002311	1	1	1	2	1	1	7
NONE	OG0002312	1	1	1	2	1	1	7
NONE	OG0002313	1	1	1	2	1	1	7
NONE	OG0002314	1	1	1	2	1	1	7
NONE	OG0002315	1	1	1	2	1	1	7
NONE	OG0002316	1	1	1	1	3	0	7
NONE	OG0002317	1	1	1	2	1	1	7
NONE	OG0002318	1	1	1	2	1	1	7
NONE	OG0002319	1	1	1	2	1	1	7
NONE	OG0002320	1	0	3	0	0	3	7
NONE	OG0002321	2	1	1	1	1	1	7
NONE	OG0002322	1	1	1	2	1	1	7
NONE	OG0002323	1	1	1	2	1	1	7
NONE	OG0002324	1	1	1	2	1	1	7
NONE	OG0002325	1	1	1	2	1	1	7
NONE	OG0002326	1	1	1	2	1	1	7
NONE	OG0002327	1	1	1	2	1	1	7
NONE	OG0002328	1	1	1	2	1	1	7
NONE	OG0002329	1	1	1	2	1	1	7
NONE	OG0002330	1	1	1	2	1	1	7
NONE	OG0002331	1	1	1	2	1	1	7
NONE	OG0002332	1	1	1	2	1	1	7
NONE	OG0002333	1	1	2	1	1	1	7
NONE	OG0002334	1	1	2	1	1	1	7
NONE	OG0002335	2	1	1	1	1	1	7
NONE	OG0002336	2	1	1	1	1	1	7
NONE	OG0002337	2	1	1	1	1	1	7
NONE	OG0002338	1	0	4	0	0	2	7
NONE	OG0002339	2	2	1	1	0	1	7
NONE	OG0002340	1	2	1	1	1	1	7
NONE	OG0002341	2	1	1	1	1	1	7
NONE	OG0002342	1	1	1	1	2	1	7
NONE	OG0002343	1	1	1	1	2	1	7
NONE	OG0002344	3	0	1	0	0	3	7
NONE	OG0002345	2	1	1	1	1	1	7
NONE	OG0002346	5	1	1	0	0	0	7
NONE	OG0002347	2	1	1	1	1	1	7
NONE	OG0002348	2	1	1	1	1	1	7
NONE	OG0002349	2	1	1	1	1	1	7
NONE	OG0002350	2	1	1	1	1	1	7
NONE	OG0002351	1	0	3	1	1	1	7
NONE	OG0002352	2	1	1	1	1	1	7
NONE	OG0002353	2	1	1	1	1	1	7
NONE	OG0002354	1	1	1	1	2	1	7
NONE	OG0002355	2	1	1	1	1	1	7
NONE	OG0002356	1	1	1	2	1	1	7
NONE	OG0002357	1	1	1	1	1	2	7
NONE	OG0002358	2	1	1	0	1	2	7
NONE	OG0002359	1	1	2	1	1	1	7
NONE	OG0002360	1	2	1	1	1	1	7
NONE	OG0002361	2	1	1	1	1	1	7
NONE	OG0002362	6	0	1	0	0	0	7
NONE	OG0002363	2	1	1	1	1	1	7
NONE	OG0002364	1	1	2	1	1	1	7
NONE	OG0002365	2	0	3	1	0	1	7
NONE	OG0002366	1	0	3	2	0	1	7
NONE	OG0002367	1	1	2	1	1	1	7
NONE	OG0002368	2	1	1	1	1	1	7
NONE	OG0002369	2	1	1	1	1	1	7
NONE	OG0002370	2	1	1	1	1	1	7
NONE	OG0002371	2	1	1	1	1	1	7
NONE	OG0002372	2	1	1	1	1	1	7
NONE	OG0002373	1	1	1	2	1	1	7
NONE	OG0002374	1	1	1	2	1	1	7
NONE	OG0002375	1	1	1	2	1	1	7
NONE	OG0002376	1	1	1	2	1	1	7
NONE	OG0002377	1	1	2	1	1	1	7
NONE	OG0002378	1	1	2	1	1	1	7
NONE	OG0002379	1	1	2	1	1	1	7
NONE	OG0002380	1	0	2	2	1	1	7
NONE	OG0002381	1	1	2	1	1	1	7
NONE	OG0002382	2	0	3	1	0	1	7
NONE	OG0002383	1	2	1	1	1	1	7
NONE	OG0002384	2	0	1	2	0	2	7
NONE	OG0002385	2	1	1	1	1	1	7
NONE	OG0002386	2	1	1	1	1	1	7
NONE	OG0002387	2	1	1	1	1	1	7
NONE	OG0002388	2	1	1	1	1	1	7
NONE	OG0002389	2	1	1	1	1	1	7
NONE	OG0002390	1	2	1	2	0	1	7
NONE	OG0002391	2	1	1	1	1	1	7
NONE	OG0002392	2	1	1	1	1	1	7
NONE	OG0002393	2	1	1	1	1	1	7
NONE	OG0002394	2	1	1	1	1	1	7
NONE	OG0002395	1	1	2	1	0	2	7
NONE	OG0002396	1	0	2	2	1	1	7
NONE	OG0002397	1	1	2	1	1	1	7
NONE	OG0002398	1	1	2	1	1	1	7
NONE	OG0002399	2	1	1	1	1	1	7
NONE	OG0002400	1	1	1	1	2	1	7
NONE	OG0002401	1	1	2	1	1	1	7
NONE	OG0002402	1	1	1	1	1	2	7
NONE	OG0002403	2	1	1	1	1	1	7
NONE	OG0002404	2	1	1	1	1	1	7
NONE	OG0002405	2	1	1	1	1	1	7
NONE	OG0002406	1	1	1	2	2	0	7
NONE	OG0002407	1	1	1	1	2	1	7
NONE	OG0002408	2	0	1	1	1	2	7
NONE	OG0002409	1	1	1	2	1	1	7
NONE	OG0002410	1	1	2	1	1	1	7
NONE	OG0002411	1	1	1	1	2	1	7
NONE	OG0002412	2	0	1	0	4	0	7
NONE	OG0002413	1	1	2	1	1	1	7
NONE	OG0002414	1	1	1	2	1	1	7
NONE	OG0002415	1	1	2	1	1	1	7
NONE	OG0002416	1	1	2	1	1	1	7
NONE	OG0002417	1	0	2	3	0	1	7
NONE	OG0002418	2	1	1	1	1	1	7
NONE	OG0002419	2	1	1	1	1	1	7
NONE	OG0002420	1	1	2	1	1	1	7
NONE	OG0002421	1	1	1	1	2	1	7
NONE	OG0002422	1	1	2	1	1	1	7
NONE	OG0002423	1	1	1	2	1	1	7
NONE	OG0002424	1	1	1	2	1	1	7
NONE	OG0002425	1	1	1	2	1	1	7
NONE	OG0002426	1	1	1	2	1	1	7
NONE	OG0002427	1	0	0	0	0	6	7
NONE	OG0002428	1	1	2	1	1	1	7
NONE	OG0002429	1	1	2	1	1	1	7
NONE	OG0002430	1	1	2	1	1	1	7
NONE	OG0002431	1	1	2	1	1	1	7
NONE	OG0002432	1	1	2	1	1	1	7
NONE	OG0002433	1	0	3	1	1	1	7
NONE	OG0002434	1	1	2	1	1	1	7
NONE	OG0002435	1	1	3	1	0	1	7
NONE	OG0002436	1	1	1	1	1	2	7
NONE	OG0002437	1	1	1	2	1	1	7
NONE	OG0002438	1	1	1	2	1	1	7
NONE	OG0002439	1	2	1	1	1	1	7
NONE	OG0002440	1	1	1	2	1	1	7
NONE	OG0002441	5	0	1	1	0	0	7
NONE	OG0002442	1	1	1	1	2	1	7
NONE	OG0002443	1	0	2	1	0	3	7
NONE	OG0002444	1	1	1	2	1	1	7
NONE	OG0002445	1	1	1	2	1	1	7
NONE	OG0002446	1	1	2	1	1	1	7
NONE	OG0002447	1	1	2	1	0	2	7
NONE	OG0002448	1	1	2	1	1	1	7
NONE	OG0002449	1	1	2	1	1	1	7
NONE	OG0002450	1	1	2	1	1	1	7
NONE	OG0002451	1	1	2	1	1	1	7
NONE	OG0002452	1	1	2	1	1	1	7
NONE	OG0002453	1	1	2	1	1	1	7
NONE	OG0002454	1	1	2	1	1	1	7
NONE	OG0002455	1	1	2	1	1	1	7
NONE	OG0002456	1	1	2	1	1	1	7
NONE	OG0002457	1	1	2	1	1	1	7
NONE	OG0002458	1	2	1	1	1	1	7
NONE	OG0002459	1	1	3	1	0	1	7
NONE	OG0002460	2	0	3	0	0	2	7
NONE	OG0002461	1	1	1	2	1	1	7
NONE	OG0002462	2	1	1	1	1	1	7
NONE	OG0002463	1	1	1	1	2	1	7
NONE	OG0002464	1	1	1	1	2	1	7
NONE	OG0002465	1	2	1	1	1	1	7
NONE	OG0002466	1	1	2	1	1	1	7
NONE	OG0002467	2	0	2	1	1	1	7
NONE	OG0002468	2	1	1	1	1	1	7
NONE	OG0002469	1	1	1	2	1	1	7
NONE	OG0002470	1	2	1	1	1	1	7
NONE	OG0002471	1	1	2	1	1	1	7
NONE	OG0002472	1	1	2	1	1	1	7
NONE	OG0002473	1	1	1	1	1	2	7
NONE	OG0002474	1	2	1	1	1	1	7
NONE	OG0002475	1	1	1	1	1	2	7
NONE	OG0002476	1	1	1	1	1	2	7
NONE	OG0002477	2	1	1	1	1	1	7
NONE	OG0002478	7	0	0	0	0	0	7
NONE	OG0002479	1	2	1	1	1	1	7
NONE	OG0002480	3	0	1	1	0	2	7
NONE	OG0002481	1	1	1	1	2	1	7
NONE	OG0002482	1	1	1	1	2	1	7
NONE	OG0002483	2	1	1	1	1	1	7
NONE	OG0002484	2	1	1	1	1	1	7
NONE	OG0002485	2	1	1	1	1	1	7
NONE	OG0002486	2	1	1	1	1	1	7
NONE	OG0002487	2	1	1	1	1	1	7
NONE	OG0002488	1	2	1	1	1	1	7
NONE	OG0002489	2	1	1	1	1	1	7
NONE	OG0002490	1	2	1	1	1	1	7
NONE	OG0002491	1	2	1	1	1	1	7
NONE	OG0002492	1	0	1	2	2	1	7
NONE	OG0002493	1	1	2	1	1	1	7
NONE	OG0002494	1	1	1	2	1	1	7
NONE	OG0002495	1	1	2	1	1	1	7
NONE	OG0002496	1	1	2	1	1	1	7
NONE	OG0002497	1	1	2	1	1	1	7
NONE	OG0002498	1	1	1	2	1	1	7
NONE	OG0002499	1	1	1	2	1	1	7
NONE	OG0002500	2	1	2	1	0	1	7
NONE	OG0002501	2	1	1	1	1	1	7
NONE	OG0002502	3	0	1	1	1	1	7
NONE	OG0002503	2	1	1	1	1	1	7
NONE	OG0002504	1	1	2	1	1	1	7
NONE	OG0002505	1	2	1	1	1	1	7
NONE	OG0002506	1	1	2	1	1	1	7
NONE	OG0002507	1	1	2	1	1	1	7
NONE	OG0002508	1	1	2	1	1	1	7
NONE	OG0002509	1	1	2	1	1	1	7
NONE	OG0002510	1	1	2	1	1	1	7
NONE	OG0002511	1	1	2	1	1	1	7
NONE	OG0002512	1	1	2	1	1	1	7
NONE	OG0002513	1	1	2	1	1	1	7
NONE	OG0002514	1	1	2	1	1	1	7
NONE	OG0002515	1	1	2	1	1	1	7
NONE	OG0002516	1	1	2	1	1	1	7
NONE	OG0002517	1	1	2	1	1	1	7
NONE	OG0002518	1	1	1	1	2	1	7
NONE	OG0002519	1	1	1	1	2	1	7
NONE	OG0002520	1	2	1	1	1	1	7
NONE	OG0002521	1	0	1	1	2	2	7
NONE	OG0002522	3	0	2	1	0	1	7
NONE	OG0002523	2	1	1	1	1	1	7
NONE	OG0002524	2	1	1	1	1	1	7
NONE	OG0002525	2	1	1	1	1	1	7
NONE	OG0002526	1	1	2	1	1	1	7
NONE	OG0002527	2	0	2	1	1	1	7
NONE	OG0002528	1	1	1	2	1	1	7
NONE	OG0002529	2	1	1	1	1	1	7
NONE	OG0002530	2	1	1	1	1	1	7
NONE	OG0002531	2	1	1	1	1	1	7
NONE	OG0002532	2	1	1	1	1	1	7
NONE	OG0002533	1	1	1	2	1	1	7
NONE	OG0002534	2	1	1	1	1	1	7
NONE	OG0002535	2	1	1	2	1	0	7
NONE	OG0002536	1	1	2	1	1	1	7
NONE	OG0002537	2	1	1	1	1	1	7
NONE	OG0002538	2	1	1	1	1	1	7
NONE	OG0002539	2	1	1	1	1	1	7
NONE	OG0002540	2	1	1	1	1	1	7
NONE	OG0002541	2	1	1	1	1	1	7
NONE	OG0002542	1	1	1	2	1	1	7
NONE	OG0002543	1	1	1	2	1	1	7
NONE	OG0002544	2	1	1	1	1	1	7
NONE	OG0002545	2	1	1	1	1	1	7
NONE	OG0002546	2	1	1	1	1	1	7
NONE	OG0002547	2	1	1	1	1	1	7
NONE	OG0002548	1	1	1	2	1	1	7
NONE	OG0002549	1	1	2	1	1	1	7
NONE	OG0002550	2	0	1	1	0	3	7
NONE	OG0002551	2	1	1	1	1	1	7
NONE	OG0002552	2	1	1	1	1	1	7
NONE	OG0002553	2	1	2	1	0	1	7
NONE	OG0002554	2	1	1	1	1	1	7
NONE	OG0002555	2	1	1	1	1	1	7
NONE	OG0002556	2	1	1	1	1	1	7
NONE	OG0002557	2	0	2	2	0	1	7
NONE	OG0002558	2	1	1	1	1	1	7
NONE	OG0002559	2	1	1	1	1	1	7
NONE	OG0002560	2	1	1	1	1	1	7
NONE	OG0002561	1	1	2	1	1	1	7
NONE	OG0002562	1	1	1	2	1	1	7
NONE	OG0002563	1	2	1	1	1	1	7
NONE	OG0002564	2	1	1	1	1	1	7
NONE	OG0002565	1	1	1	2	1	1	7
NONE	OG0002566	1	1	2	1	1	1	7
NONE	OG0002567	1	1	2	1	1	1	7
NONE	OG0002568	1	1	1	1	2	1	7
NONE	OG0002569	1	1	1	1	1	2	7
NONE	OG0002570	1	2	1	1	1	1	7
NONE	OG0002571	2	1	1	1	1	1	7
NONE	OG0002572	1	1	2	1	1	1	7
NONE	OG0002573	1	2	1	1	1	1	7
NONE	OG0002574	3	0	1	0	1	2	7
NONE	OG0002575	2	0	0	3	1	1	7
NONE	OG0002576	2	1	1	1	1	1	7
NONE	OG0002577	2	1	1	1	1	1	7
NONE	OG0002578	1	1	2	1	1	1	7
NONE	OG0002579	1	1	2	1	1	1	7
NONE	OG0002580	1	1	2	1	1	1	7
NONE	OG0002581	2	1	2	1	0	1	7
NONE	OG0002582	1	0	3	1	1	1	7
NONE	OG0002583	4	0	2	1	0	0	7
NONE	OG0002584	3	0	1	1	1	1	7
NONE	OG0002585	1	1	1	1	2	1	7
NONE	OG0002586	1	1	2	1	1	1	7
NONE	OG0002587	1	2	1	1	1	1	7
NONE	OG0002588	1	1	1	2	1	1	7
NONE	OG0002589	2	1	1	1	1	1	7
NONE	OG0002590	2	1	1	1	1	1	7
NONE	OG0002591	2	1	1	1	1	1	7
NONE	OG0002592	2	1	1	1	1	1	7
NONE	OG0002593	2	0	2	1	1	1	7
NONE	OG0002594	1	1	2	1	1	1	7
NONE	OG0002595	1	0	3	1	1	1	7
NONE	OG0002596	2	1	1	1	1	1	7
NONE	OG0002597	1	1	2	1	1	1	7
NONE	OG0002598	1	1	2	1	1	1	7
NONE	OG0002599	1	1	1	1	1	2	7
NONE	OG0002600	2	1	1	1	1	1	7
NONE	OG0002601	2	1	1	1	1	1	7
NONE	OG0002602	1	1	2	1	1	1	7
NONE	OG0002603	2	0	1	1	1	2	7
NONE	OG0002604	1	1	1	2	1	1	7
NONE	OG0002605	1	1	1	2	1	1	7
NONE	OG0002606	2	1	1	1	1	1	7
NONE	OG0002607	2	1	1	1	1	1	7
NONE	OG0002608	1	1	2	1	1	1	7
NONE	OG0002609	1	1	2	1	1	1	7
NONE	OG0002610	2	0	1	1	1	2	7
NONE	OG0002611	2	1	1	1	1	1	7
NONE	OG0002612	2	1	1	1	1	1	7
NONE	OG0002613	2	1	1	1	1	1	7
NONE	OG0002614	2	1	1	1	1	1	7
NONE	OG0002615	1	1	1	1	2	1	7
NONE	OG0002616	1	1	1	1	2	1	7
NONE	OG0002617	2	1	1	1	1	1	7
NONE	OG0002618	1	1	2	3	0	0	7
NONE	OG0002619	1	1	2	1	1	1	7
NONE	OG0002620	2	1	1	1	1	1	7
NONE	OG0002621	2	1	1	1	1	1	7
NONE	OG0002622	1	0	2	1	0	3	7
NONE	OG0002623	1	1	1	2	1	1	7
NONE	OG0002624	1	1	1	2	1	1	7
NONE	OG0002625	1	2	1	1	1	1	7
NONE	OG0002626	2	1	1	1	1	1	7
NONE	OG0002627	2	1	1	1	1	1	7
NONE	OG0002628	1	1	2	1	1	1	7
NONE	OG0002629	2	1	1	1	1	1	7
NONE	OG0002630	2	1	1	0	2	1	7
NONE	OG0002631	2	0	1	2	1	1	7
NONE	OG0002632	1	0	1	3	0	2	7
NONE	OG0002633	1	1	1	2	1	1	7
NONE	OG0002634	1	1	1	2	1	1	7
NONE	OG0002635	1	1	1	2	1	1	7
NONE	OG0002636	1	1	1	2	1	1	7
NONE	OG0002637	1	1	1	1	2	1	7
NONE	OG0002638	2	0	3	0	0	2	7
NONE	OG0002639	5	0	2	0	0	0	7
NONE	OG0002640	1	1	2	1	1	1	7
NONE	OG0002641	1	1	2	1	1	1	7
NONE	OG0002642	1	1	2	1	1	1	7
NONE	OG0002643	1	1	2	1	1	1	7
NONE	OG0002644	3	0	1	1	1	1	7
NONE	OG0002645	2	1	1	1	1	1	7
NONE	OG0002646	5	0	2	0	0	0	7
NONE	OG0002647	1	1	2	1	1	1	7
NONE	OG0002648	2	1	1	1	1	1	7
NONE	OG0002649	1	1	1	2	1	1	7
NONE	OG0002650	2	1	1	1	1	1	7
NONE	OG0002651	2	1	1	1	1	1	7
NONE	OG0002652	1	1	1	1	2	1	7
NONE	OG0002653	2	1	1	1	1	1	7
NONE	OG0002654	2	0	1	2	1	1	7
NONE	OG0002655	1	1	1	2	1	1	7
NONE	OG0002656	2	1	1	1	1	1	7
NONE	OG0002657	1	1	1	2	1	1	7
NONE	OG0002658	1	1	2	1	1	1	7
NONE	OG0002659	1	1	2	1	1	1	7
NONE	OG0002660	1	2	1	1	1	1	7
NONE	OG0002661	2	1	1	1	1	1	7
NONE	OG0002662	5	0	2	0	0	0	7
NONE	OG0002663	1	1	1	2	1	1	7
NONE	OG0002664	1	1	2	1	1	1	7
NONE	OG0002665	1	0	2	2	1	1	7
NONE	OG0002666	1	1	1	1	1	2	7
NONE	OG0002667	1	1	1	1	2	1	7
NONE	OG0002668	2	1	1	1	1	1	7
NONE	OG0002669	2	0	1	1	2	1	7
NONE	OG0002670	2	0	2	1	0	2	7
NONE	OG0002671	2	1	1	1	1	1	7
NONE	OG0002672	2	1	1	1	1	1	7
NONE	OG0002673	2	1	1	1	1	1	7
NONE	OG0002674	2	1	1	1	1	1	7
NONE	OG0002675	1	1	1	2	1	1	7
NONE	OG0002676	1	1	1	2	1	1	7
NONE	OG0002677	1	1	1	1	1	2	7
NONE	OG0002678	1	1	2	1	1	1	7
NONE	OG0002679	1	1	1	1	2	1	7
NONE	OG0002680	1	1	1	1	2	1	7
NONE	OG0002681	1	2	1	3	0	0	7
NONE	OG0002682	1	1	1	1	2	1	7
NONE	OG0002683	1	1	1	2	1	1	7
NONE	OG0002684	1	1	1	2	1	1	7
NONE	OG0002685	2	1	1	1	1	1	7
NONE	OG0002686	2	1	1	1	1	1	7
NONE	OG0002687	1	1	2	1	1	1	7
NONE	OG0002688	2	1	1	1	1	1	7
NONE	OG0002689	1	1	1	2	1	1	7
NONE	OG0002690	1	1	1	2	1	1	7
NONE	OG0002691	1	1	1	2	1	1	7
NONE	OG0002692	1	1	1	2	1	1	7
NONE	OG0002693	1	0	2	2	1	1	7
NONE	OG0002694	1	0	2	2	1	1	7
NONE	OG0002695	1	1	1	2	1	1	7
NONE	OG0002696	2	0	1	2	1	1	7
NONE	OG0002697	1	1	1	2	1	1	7
NONE	OG0002698	1	1	1	2	1	1	7
NONE	OG0002699	1	1	1	2	1	1	7
NONE	OG0002700	1	1	1	2	1	1	7
NONE	OG0002701	1	1	1	2	1	1	7
NONE	OG0002702	1	1	1	2	1	1	7
NONE	OG0002703	1	1	1	2	1	1	7
NONE	OG0002704	1	1	1	1	2	1	7
NONE	OG0002705	1	1	2	1	1	1	7
NONE	OG0002706	1	1	2	1	1	1	7
NONE	OG0002707	2	0	1	0	0	4	7
NONE	OG0002708	1	2	1	1	1	1	7
NONE	OG0002709	1	1	1	1	1	2	7
NONE	OG0002710	2	1	1	1	1	1	7
NONE	OG0002711	1	1	1	2	1	1	7
NONE	OG0002712	4	0	3	0	0	0	7
NONE	OG0002713	2	1	1	1	1	1	7
NONE	OG0002714	1	1	1	1	2	1	7
NONE	OG0002715	1	1	1	1	1	2	7
NONE	OG0002716	2	1	1	1	1	1	7
NONE	OG0002717	2	1	1	1	1	1	7
NONE	OG0002718	1	0	2	1	1	2	7
NONE	OG0002719	1	1	1	1	2	1	7
NONE	OG0002720	1	1	1	1	2	1	7
NONE	OG0002721	3	0	1	3	0	0	7
NONE	OG0002722	3	0	4	0	0	0	7
NONE	OG0002723	1	2	1	1	1	1	7
NONE	OG0002724	1	2	1	1	1	1	7
NONE	OG0002725	1	1	1	1	1	2	7
NONE	OG0002726	1	1	1	2	1	1	7
NONE	OG0002727	1	1	1	2	1	1	7
NONE	OG0002728	1	1	1	1	2	1	7
NONE	OG0002729	1	1	1	2	1	1	7
NONE	OG0002730	1	1	1	2	1	1	7
NONE	OG0002731	2	1	1	1	1	1	7
NONE	OG0002732	1	1	1	1	2	1	7
NONE	OG0002733	1	1	2	1	1	1	7
NONE	OG0002734	2	1	1	1	1	1	7
NONE	OG0002735	1	0	6	0	0	0	7
NONE	OG0002736	1	1	1	3	0	1	7
NONE	OG0002737	2	2	1	1	0	1	7
NONE	OG0002738	2	1	1	1	1	1	7
NONE	OG0002739	2	1	1	1	1	1	7
NONE	OG0002740	2	1	1	1	1	1	7
NONE	OG0002741	2	1	1	1	1	1	7
NONE	OG0002742	2	1	1	1	1	1	7
NONE	OG0002743	2	1	1	1	1	1	7
NONE	OG0002744	1	0	1	2	1	2	7
NONE	OG0002745	1	0	2	1	2	1	7
NONE	OG0002746	2	1	1	1	1	1	7
NONE	OG0002747	2	1	1	1	1	1	7
NONE	OG0002748	2	1	1	1	1	1	7
NONE	OG0002749	2	1	1	1	1	1	7
NONE	OG0002750	2	1	1	1	1	1	7
NONE	OG0002751	1	0	1	1	3	1	7
NONE	OG0002752	1	0	3	2	0	1	7
NONE	OG0002753	1	0	5	0	0	1	7
NONE	OG0002754	1	2	1	2	0	1	7
NONE	OG0002755	1	1	1	2	1	1	7
NONE	OG0002756	1	1	1	2	1	1	7
NONE	OG0002757	1	1	1	2	1	1	7
NONE	OG0002758	1	1	1	2	1	1	7
NONE	OG0002759	1	2	1	1	1	1	7
NONE	OG0002760	1	1	1	1	2	1	7
NONE	OG0002761	1	1	1	2	1	1	7
NONE	OG0002762	2	1	1	1	1	1	7
NONE	OG0002763	2	1	1	1	1	1	7
NONE	OG0002764	1	1	1	2	1	1	7
NONE	OG0002765	1	1	1	2	1	1	7
NONE	OG0002766	1	1	1	1	2	1	7
NONE	OG0002767	1	1	1	2	1	1	7
NONE	OG0002768	2	0	1	1	2	1	7
NONE	OG0002769	1	0	4	1	0	1	7
NONE	OG0002770	1	0	4	0	1	1	7
NONE	OG0002771	1	1	2	1	1	1	7
NONE	OG0002772	1	1	2	1	1	1	7
NONE	OG0002773	1	1	2	1	1	1	7
NONE	OG0002774	5	0	0	1	0	1	7
NONE	OG0002775	1	1	2	1	1	1	7
NONE	OG0002776	2	0	2	1	0	2	7
NONE	OG0002777	1	1	3	0	1	1	7
NONE	OG0002778	1	0	3	1	1	1	7
NONE	OG0002779	1	1	2	1	1	1	7
NONE	OG0002780	1	1	1	2	1	1	7
NONE	OG0002781	2	1	1	1	1	1	7
NONE	OG0002782	2	1	1	1	1	1	7
NONE	OG0002783	2	1	1	1	1	1	7
NONE	OG0002784	2	0	1	2	1	1	7
NONE	OG0002785	1	1	1	2	1	1	7
NONE	OG0002786	2	1	1	1	1	1	7
NONE	OG0002787	2	1	1	1	1	1	7
NONE	OG0002788	2	1	1	1	1	1	7
NONE	OG0002789	2	1	1	1	1	1	7
NONE	OG0002790	2	1	1	1	1	1	7
NONE	OG0002791	2	1	1	1	1	1	7
NONE	OG0002792	2	1	1	1	1	1	7
NONE	OG0002793	1	1	2	1	1	1	7
NONE	OG0002794	2	1	1	1	1	1	7
NONE	OG0002795	2	1	1	1	1	1	7
NONE	OG0002796	2	1	1	1	1	1	7
NONE	OG0002797	1	1	1	1	1	2	7
NONE	OG0002798	1	1	2	1	1	1	7
NONE	OG0002799	1	1	1	2	1	1	7
NONE	OG0002800	1	1	1	1	2	1	7
NONE	OG0002801	2	1	1	1	1	1	7
NONE	OG0002802	2	1	1	1	1	1	7
NONE	OG0002803	2	1	1	1	1	1	7
NONE	OG0002804	1	1	2	1	1	1	7
NONE	OG0002805	1	1	1	2	1	1	7
NONE	OG0002806	1	0	0	4	0	2	7
NONE	OG0002807	2	1	1	1	1	1	7
NONE	OG0002808	1	1	1	1	1	2	7
NONE	OG0002809	2	1	1	1	1	1	7
NONE	OG0002810	1	1	1	2	1	1	7
NONE	OG0002811	2	1	1	2	0	1	7
NONE	OG0002812	2	1	1	1	1	1	7
NONE	OG0002813	1	0	3	1	1	1	7
NONE	OG0002814	1	2	1	1	1	1	7
NONE	OG0002815	2	1	1	1	1	1	7
NONE	OG0002816	2	1	1	1	1	1	7
NONE	OG0002817	2	1	1	1	1	1	7
NONE	OG0002818	2	1	1	1	1	1	7
NONE	OG0002819	1	2	1	1	1	1	7
NONE	OG0002820	1	1	2	1	1	1	7
NONE	OG0002821	1	1	3	1	1	0	7
NONE	OG0002822	2	0	4	1	0	0	7
NONE	OG0002823	1	0	1	1	3	1	7
NONE	OG0002824	2	1	1	1	1	1	7
NONE	OG0002825	1	1	1	1	2	1	7
NONE	OG0002826	2	1	1	1	1	1	7
NONE	OG0002827	1	1	2	1	1	1	7
NONE	OG0002828	1	1	1	1	2	1	7
NONE	OG0002829	1	1	1	1	2	1	7
NONE	OG0002830	2	1	1	1	1	1	7
NONE	OG0002831	2	1	1	1	1	1	7
NONE	OG0002832	2	1	1	1	1	1	7
NONE	OG0002833	2	1	1	1	1	1	7
NONE	OG0002834	1	1	1	2	1	1	7
NONE	OG0002835	1	1	1	2	1	1	7
NONE	OG0002836	2	1	1	1	1	1	7
NONE	OG0002837	1	1	1	2	1	1	7
NONE	OG0002838	2	0	1	1	1	2	7
NONE	OG0002839	1	1	1	1	2	1	7
NONE	OG0002840	2	1	1	1	1	1	7
NONE	OG0002841	2	1	1	1	1	1	7
NONE	OG0002842	2	1	1	1	1	1	7
NONE	OG0002843	1	1	2	1	1	1	7
NONE	OG0002844	2	1	1	1	1	1	7
NONE	OG0002845	1	1	2	1	1	1	7
NONE	OG0002846	1	1	2	1	1	1	7
NONE	OG0002847	2	1	1	1	1	1	7
NONE	OG0002848	1	1	1	1	1	2	7
NONE	OG0002849	2	1	1	2	0	1	7
NONE	OG0002850	1	1	1	2	1	1	7
NONE	OG0002851	3	0	3	1	0	0	7
NONE	OG0002852	1	1	2	1	1	1	7
NONE	OG0002853	1	2	2	1	0	1	7
NONE	OG0002854	1	1	2	1	1	1	7
NONE	OG0002855	1	1	2	1	1	1	7
NONE	OG0002856	1	1	2	1	1	1	7
NONE	OG0002857	2	1	1	1	1	1	7
NONE	OG0002858	2	1	1	1	1	1	7
NONE	OG0002859	2	1	1	1	1	1	7
NONE	OG0002860	1	1	1	2	1	1	7
NONE	OG0002861	2	1	1	1	1	1	7
NONE	OG0002862	1	1	1	2	1	1	7
NONE	OG0002863	1	1	1	2	1	1	7
NONE	OG0002864	2	0	2	3	0	0	7
NONE	OG0002865	2	1	1	1	1	1	7
NONE	OG0002866	1	1	1	1	1	2	7
NONE	OG0002867	2	1	1	1	0	2	7
NONE	OG0002868	5	0	2	0	0	0	7
NONE	OG0002869	7	0	0	0	0	0	7
NONE	OG0002870	1	1	1	2	1	1	7
NONE	OG0002871	1	1	1	1	1	2	7
NONE	OG0002872	1	1	1	1	2	1	7
NONE	OG0002873	1	1	1	1	2	1	7
NONE	OG0002874	2	1	1	1	1	1	7
NONE	OG0002875	2	1	1	1	1	1	7
NONE	OG0002876	2	1	1	1	1	1	7
NONE	OG0002877	1	1	2	1	1	1	7
NONE	OG0002878	1	2	1	1	1	1	7
NONE	OG0002879	1	1	1	2	1	1	7
NONE	OG0002880	3	0	1	0	1	2	7
NONE	OG0002881	1	1	1	1	2	1	7
NONE	OG0002882	1	0	2	1	2	1	7
NONE	OG0002883	1	1	1	1	2	1	7
NONE	OG0002884	2	1	1	1	1	1	7
NONE	OG0002885	2	1	1	1	1	1	7
NONE	OG0002886	2	1	2	1	0	1	7
NONE	OG0002887	1	1	2	1	1	1	7
NONE	OG0002888	1	1	2	1	1	1	7
NONE	OG0002889	1	1	1	2	1	1	7
NONE	OG0002890	2	1	1	1	1	1	7
NONE	OG0002891	2	0	4	0	0	1	7
NONE	OG0002892	1	1	2	1	1	1	7
NONE	OG0002893	1	1	2	1	1	1	7
NONE	OG0002894	1	1	2	1	1	1	7
NONE	OG0002895	1	1	1	1	1	2	7
NONE	OG0002896	1	0	1	1	0	4	7
NONE	OG0002897	2	1	1	1	1	1	7
NONE	OG0002898	2	1	1	1	1	1	7
NONE	OG0002899	2	1	1	1	1	1	7
NONE	OG0002900	2	1	1	1	1	1	7
NONE	OG0002901	2	1	1	1	1	1	7
NONE	OG0002902	2	1	1	1	1	1	7
NONE	OG0002903	2	1	1	1	1	1	7
NONE	OG0002904	2	1	1	1	1	1	7
NONE	OG0002905	1	1	1	2	1	1	7
NONE	OG0002906	1	1	1	2	1	1	7
NONE	OG0002907	1	1	2	1	1	1	7
NONE	OG0002908	2	0	2	1	1	1	7
NONE	OG0002909	2	0	2	2	0	1	7
NONE	OG0002910	1	1	1	2	1	1	7
NONE	OG0002911	1	1	1	1	2	1	7
NONE	OG0002912	1	1	1	2	1	1	7
NONE	OG0002913	1	1	1	2	1	1	7
NONE	OG0002914	1	1	1	2	1	1	7
NONE	OG0002915	1	1	1	2	1	1	7
NONE	OG0002916	1	1	1	2	1	1	7
NONE	OG0002917	1	1	1	2	1	1	7
NONE	OG0002918	1	1	1	2	1	1	7
NONE	OG0002919	1	1	1	2	1	1	7
NONE	OG0002920	1	1	1	2	1	1	7
NONE	OG0002921	1	0	6	0	0	0	7
NONE	OG0002922	1	2	1	1	1	1	7
NONE	OG0002923	1	1	1	1	2	1	7
NONE	OG0002924	1	1	1	1	2	1	7
NONE	OG0002925	1	1	2	1	1	1	7
NONE	OG0002926	2	1	1	1	1	1	7
NONE	OG0002927	2	1	1	1	1	1	7
NONE	OG0002928	1	2	1	1	1	1	7
NONE	OG0002929	1	0	3	2	0	1	7
NONE	OG0002930	1	0	3	1	1	1	7
NONE	OG0002931	2	0	1	2	0	2	7
NONE	OG0002932	2	1	1	2	0	1	7
NONE	OG0002933	1	1	2	1	1	1	7
NONE	OG0002934	1	1	2	1	1	1	7
NONE	OG0002935	1	1	2	2	0	1	7
NONE	OG0002936	1	2	1	1	1	1	7
NONE	OG0002937	1	1	1	1	1	2	7
NONE	OG0002938	1	0	2	3	0	1	7
NONE	OG0002939	2	0	2	2	1	0	7
NONE	OG0002940	1	1	2	1	1	1	7
NONE	OG0002941	1	1	2	1	1	1	7
NONE	OG0002942	1	1	1	1	1	2	7
NONE	OG0002943	1	1	2	1	1	1	7
NONE	OG0002944	2	0	3	2	0	0	7
NONE	OG0002945	1	1	1	1	2	1	7
NONE	OG0002946	2	1	1	1	1	1	7
NONE	OG0002947	1	1	1	2	1	1	7
NONE	OG0002948	1	1	1	2	1	1	7
NONE	OG0002949	2	1	1	1	1	1	7
NONE	OG0002950	2	1	1	1	1	1	7
NONE	OG0002951	2	0	1	3	0	1	7
NONE	OG0002952	1	1	1	1	1	2	7
NONE	OG0002953	2	1	1	1	1	1	7
NONE	OG0002954	1	1	1	2	1	1	7
NONE	OG0002955	1	1	1	2	1	1	7
NONE	OG0002956	1	1	1	2	1	1	7
NONE	OG0002957	1	1	1	2	1	1	7
NONE	OG0002958	1	1	1	2	1	1	7
NONE	OG0002959	1	1	1	2	1	1	7
NONE	OG0002960	1	1	1	2	1	1	7
NONE	OG0002961	1	1	1	2	1	1	7
NONE	OG0002962	1	1	1	2	1	1	7
NONE	OG0002963	1	1	1	2	1	1	7
NONE	OG0002964	1	1	1	2	1	1	7
NONE	OG0002965	1	1	1	2	1	1	7
NONE	OG0002966	1	1	1	2	1	1	7
NONE	OG0002967	1	1	1	2	1	1	7
NONE	OG0002968	1	2	1	1	1	1	7
NONE	OG0002969	1	1	1	2	1	1	7
NONE	OG0002970	3	1	1	0	0	2	7
NONE	OG0002971	1	1	1	2	1	1	7
NONE	OG0002972	1	1	1	1	2	1	7
NONE	OG0002973	1	1	1	2	1	1	7
NONE	OG0002974	1	1	1	2	1	1	7
NONE	OG0002975	1	1	1	2	1	1	7
NONE	OG0002976	1	1	1	2	1	1	7
NONE	OG0002977	1	2	1	1	1	1	7
NONE	OG0002978	1	1	1	1	2	1	7
NONE	OG0002979	1	1	1	1	2	1	7
NONE	OG0002980	1	1	1	1	2	1	7
NONE	OG0002981	1	1	1	2	1	1	7
NONE	OG0002982	2	0	1	2	1	1	7
NONE	OG0002983	1	1	1	2	1	1	7
NONE	OG0002984	1	1	1	2	1	1	7
NONE	OG0002985	1	1	1	2	1	1	7
NONE	OG0002986	1	1	2	1	1	1	7
NONE	OG0002987	3	0	2	1	0	1	7
NONE	OG0002988	1	1	2	1	1	1	7
NONE	OG0002989	1	1	2	1	1	1	7
NONE	OG0002990	2	1	1	1	1	1	7
NONE	OG0002991	1	1	1	2	1	1	7
NONE	OG0002992	1	1	1	2	1	1	7
NONE	OG0002993	1	1	1	2	1	1	7
NONE	OG0002994	1	1	2	1	1	1	7
NONE	OG0002995	1	1	2	1	1	1	7
NONE	OG0002996	1	1	1	1	2	1	7
NONE	OG0002997	1	0	2	2	0	2	7
NONE	OG0002998	1	1	1	1	2	1	7
NONE	OG0002999	1	1	1	2	1	1	7
NONE	OG0003000	1	1	1	2	1	1	7
NONE	OG0003001	1	1	1	1	1	2	7
NONE	OG0003002	2	0	2	2	0	1	7
NONE	OG0003003	2	1	1	1	1	1	7
NONE	OG0003004	1	1	1	2	1	1	7
NONE	OG0003005	1	1	3	1	0	1	7
NONE	OG0003006	1	1	2	1	1	1	7
NONE	OG0003007	1	1	2	1	1	1	7
NONE	OG0003008	1	1	2	1	1	1	7
NONE	OG0003009	2	0	2	1	1	1	7
NONE	OG0003010	2	1	1	1	1	1	7
NONE	OG0003011	1	2	1	1	1	1	7
NONE	OG0003012	1	2	1	1	1	1	7
NONE	OG0003013	1	0	0	0	0	6	7
NONE	OG0003014	1	2	1	1	1	1	7
NONE	OG0003015	1	1	1	1	1	2	7
NONE	OG0003016	2	1	1	1	1	1	7
NONE	OG0003017	2	1	1	1	1	1	7
NONE	OG0003018	2	1	1	1	1	1	7
NONE	OG0003019	2	1	1	1	1	1	7
NONE	OG0003020	2	1	1	1	1	1	7
NONE	OG0003021	2	1	1	1	1	1	7
NONE	OG0003022	2	1	1	1	1	1	7
NONE	OG0003023	2	1	1	1	1	1	7
NONE	OG0003024	2	1	1	1	1	1	7
NONE	OG0003025	1	1	1	2	1	1	7
NONE	OG0003026	1	1	2	1	1	1	7
NONE	OG0003027	1	1	2	1	1	1	7
NONE	OG0003028	1	1	2	1	1	1	7
NONE	OG0003029	2	1	1	1	1	1	7
NONE	OG0003030	1	1	1	4	0	0	7
NONE	OG0003031	1	1	1	2	1	1	7
NONE	OG0003032	2	1	1	1	1	1	7
NONE	OG0003033	1	1	1	1	1	2	7
NONE	OG0003034	1	2	1	1	1	1	7
NONE	OG0003035	1	2	1	2	0	1	7
NONE	OG0003036	2	1	1	1	1	1	7
NONE	OG0003037	1	2	1	1	1	1	7
NONE	OG0003038	2	1	1	1	1	1	7
NONE	OG0003039	2	1	1	1	1	1	7
NONE	OG0003040	1	1	2	1	1	1	7
NONE	OG0003041	1	1	1	2	1	1	7
NONE	OG0003042	2	1	1	1	1	1	7
NONE	OG0003043	2	0	2	1	1	1	7
NONE	OG0003044	1	1	1	2	1	1	7
NONE	OG0003045	1	1	1	2	1	1	7
NONE	OG0003046	2	1	1	1	1	1	7
NONE	OG0003047	2	1	1	1	1	1	7
NONE	OG0003048	2	1	1	1	1	1	7
NONE	OG0003049	2	1	1	1	1	1	7
NONE	OG0003050	1	1	2	1	1	1	7
NONE	OG0003051	1	1	1	2	1	1	7
NONE	OG0003052	1	2	2	0	1	1	7
NONE	OG0003053	2	1	1	1	1	1	7
NONE	OG0003054	2	1	1	1	1	1	7
NONE	OG0003055	1	1	2	1	1	1	7
NONE	OG0003056	1	2	1	1	1	1	7
NONE	OG0003057	1	1	1	1	2	1	7
NONE	OG0003058	1	1	2	1	1	1	7
NONE	OG0003059	1	1	2	1	1	1	7
NONE	OG0003060	1	1	1	2	1	1	7
NONE	OG0003061	2	1	1	1	1	1	7
NONE	OG0003062	2	1	1	1	1	1	7
NONE	OG0003063	1	1	2	1	1	1	7
NONE	OG0003064	2	1	1	1	1	1	7
NONE	OG0003065	2	1	1	1	1	1	7
NONE	OG0003066	2	1	1	1	1	1	7
NONE	OG0003067	2	1	1	1	1	1	7
NONE	OG0003068	2	1	1	1	1	1	7
NONE	OG0003069	1	3	1	1	0	1	7
NONE	OG0003070	1	2	1	1	1	1	7
NONE	OG0003071	1	1	2	1	1	1	7
NONE	OG0003072	1	0	3	0	0	3	7
NONE	OG0003073	2	1	1	1	1	1	7
NONE	OG0003074	1	1	1	2	1	1	7
NONE	OG0003075	2	0	1	2	0	2	7
NONE	OG0003076	1	1	1	2	1	1	7
NONE	OG0003077	1	1	2	1	1	1	7
NONE	OG0003078	1	1	2	1	1	1	7
NONE	OG0003079	2	1	1	1	1	1	7
NONE	OG0003080	2	1	1	1	1	1	7
NONE	OG0003081	1	1	2	1	1	1	7
NONE	OG0003082	1	1	1	1	2	1	7
NONE	OG0003083	1	1	1	1	2	1	7
NONE	OG0003084	2	1	1	1	1	1	7
NONE	OG0003085	2	1	1	1	1	1	7
NONE	OG0003086	2	1	1	1	1	1	7
NONE	OG0003087	2	1	1	1	1	1	7
NONE	OG0003088	2	1	1	1	1	1	7
NONE	OG0003089	2	0	2	1	1	1	7
NONE	OG0003090	2	0	1	1	2	1	7
NONE	OG0003091	2	1	1	1	1	1	7
NONE	OG0003092	2	1	1	1	1	1	7
NONE	OG0003093	2	1	1	1	1	1	7
NONE	OG0003094	1	1	1	1	2	1	7
NONE	OG0003095	2	1	1	1	1	1	7
NONE	OG0003096	2	1	1	1	1	1	7
NONE	OG0003097	2	1	1	1	1	1	7
NONE	OG0003098	1	1	1	2	1	1	7
NONE	OG0003099	2	1	1	1	1	1	7
NONE	OG0003100	1	1	2	1	1	1	7
NONE	OG0003101	1	1	1	2	1	1	7
NONE	OG0003102	2	1	1	1	1	1	7
NONE	OG0003103	1	1	1	2	1	1	7
NONE	OG0003104	1	1	1	2	1	1	7
NONE	OG0003105	1	2	1	1	1	1	7
NONE	OG0003106	1	1	1	2	1	1	7
NONE	OG0003107	1	1	1	2	1	1	7
NONE	OG0003108	1	1	1	2	1	1	7
NONE	OG0003109	1	1	1	1	1	2	7
NONE	OG0003110	1	1	1	1	2	1	7
NONE	OG0003111	1	1	1	1	2	1	7
NONE	OG0003112	3	0	1	2	0	1	7
NONE	OG0003113	1	1	1	2	1	1	7
NONE	OG0003114	1	1	1	2	1	1	7
NONE	OG0003115	1	1	1	3	0	1	7
NONE	OG0003116	2	1	1	1	1	1	7
NONE	OG0003117	1	1	1	2	1	1	7
NONE	OG0003118	1	1	1	2	1	1	7
NONE	OG0003119	1	1	1	2	1	1	7
NONE	OG0003120	1	1	1	2	1	1	7
NONE	OG0003121	2	1	1	1	1	1	7
NONE	OG0003122	1	1	2	1	1	1	7
NONE	OG0003123	1	1	2	1	1	1	7
NONE	OG0003124	2	1	1	1	1	1	7
NONE	OG0003125	2	1	1	1	1	1	7
NONE	OG0003126	2	1	1	1	1	1	7
NONE	OG0003127	1	1	1	2	1	1	7
NONE	OG0003128	2	1	1	1	1	1	7
NONE	OG0003129	2	1	1	1	1	1	7
NONE	OG0003130	1	1	1	1	0	3	7
NONE	OG0003131	1	1	2	1	1	1	7
NONE	OG0003132	1	1	2	1	1	1	7
NONE	OG0003133	1	1	2	1	1	1	7
NONE	OG0003134	1	1	2	1	1	1	7
NONE	OG0003135	1	1	2	1	1	1	7
NONE	OG0003136	2	1	1	1	1	1	7
NONE	OG0003137	1	0	0	0	0	6	7
NONE	OG0003138	2	1	1	1	1	1	7
NONE	OG0003139	2	1	1	1	1	1	7
NONE	OG0003140	2	1	1	1	1	1	7
NONE	OG0003141	2	1	1	1	1	1	7
NONE	OG0003142	2	1	1	1	1	1	7
NONE	OG0003143	2	1	1	1	1	1	7
NONE	OG0003144	1	1	1	1	2	1	7
NONE	OG0003145	1	1	1	2	1	1	7
NONE	OG0003146	1	2	1	1	1	1	7
NONE	OG0003147	1	1	1	2	1	1	7
NONE	OG0003148	1	1	1	1	2	1	7
NONE	OG0003149	2	1	1	1	1	1	7
NONE	OG0003150	2	1	1	1	1	1	7
NONE	OG0003151	2	1	1	1	1	1	7
NONE	OG0003152	2	1	1	1	1	1	7
NONE	OG0003153	2	1	1	1	1	1	7
NONE	OG0003154	2	1	1	1	1	1	7
NONE	OG0003155	1	1	2	1	1	1	7
NONE	OG0003156	2	0	4	0	0	1	7
NONE	OG0003157	1	1	1	2	1	1	7
NONE	OG0003158	1	1	2	1	1	1	7
NONE	OG0003159	2	1	1	1	1	1	7
NONE	OG0003160	2	1	1	1	1	1	7
NONE	OG0003161	2	1	1	1	1	1	7
NONE	OG0003162	2	1	1	1	1	1	7
NONE	OG0003163	1	1	2	1	1	1	7
NONE	OG0003164	1	1	2	1	1	1	7
NONE	OG0003165	2	1	1	1	1	1	7
NONE	OG0003166	1	0	1	1	0	4	7
NONE	OG0003167	1	1	1	1	1	2	7
NONE	OG0003168	1	1	1	2	1	1	7
NONE	OG0003169	3	0	2	0	0	2	7
NONE	OG0003170	1	1	1	1	1	2	7
NONE	OG0003171	1	1	1	2	1	1	7
NONE	OG0003172	2	0	1	2	1	1	7
NONE	OG0003173	1	1	1	1	2	1	7
NONE	OG0003174	1	1	2	1	1	1	7
NONE	OG0003175	1	1	2	1	1	1	7
NONE	OG0003176	1	1	3	1	1	0	7
NONE	OG0003177	2	1	2	1	1	0	7
NONE	OG0003178	2	1	2	1	1	0	7
NONE	OG0003179	2	0	2	1	1	1	7
NONE	OG0003180	1	1	2	1	1	1	7
NONE	OG0003181	1	2	1	1	1	1	7
NONE	OG0003182	1	1	1	1	2	1	7
NONE	OG0003183	3	1	0	2	0	1	7
NONE	OG0003184	1	2	1	1	1	1	7
NONE	OG0003185	1	1	1	2	1	1	7
NONE	OG0003186	1	1	1	2	1	1	7
NONE	OG0003187	1	1	1	1	1	2	7
NONE	OG0003188	1	0	6	0	0	0	7
NONE	OG0003189	1	1	1	2	1	1	7
NONE	OG0003190	2	0	5	0	0	0	7
NONE	OG0003191	2	1	1	1	1	1	7
NONE	OG0003192	1	1	2	1	1	1	7
NONE	OG0003193	1	1	2	1	1	1	7
NONE	OG0003194	1	1	2	1	1	1	7
NONE	OG0003195	1	1	2	1	1	1	7
NONE	OG0003196	1	1	2	1	1	1	7
NONE	OG0003197	1	0	1	1	1	3	7
NONE	OG0003198	1	1	1	2	1	1	7
NONE	OG0003199	1	1	1	1	1	2	7
NONE	OG0003200	1	1	1	2	1	1	7
NONE	OG0003201	1	1	1	2	1	1	7
NONE	OG0003202	1	1	1	1	2	1	7
NONE	OG0003203	1	1	1	1	1	2	7
NONE	OG0003204	1	1	1	1	2	1	7
NONE	OG0003205	1	1	1	2	1	1	7
NONE	OG0003206	1	1	1	1	2	1	7
NONE	OG0003207	1	1	1	1	1	2	7
NONE	OG0003208	2	1	1	1	1	1	7
NONE	OG0003209	1	1	1	2	1	1	7
NONE	OG0003210	1	1	2	1	1	1	7
NONE	OG0003211	1	2	1	1	1	1	7
NONE	OG0003212	1	1	3	1	0	1	7
NONE	OG0003213	1	2	1	1	1	1	7
NONE	OG0003214	2	1	1	1	1	1	7
NONE	OG0003215	1	1	2	1	1	1	7
NONE	OG0003216	1	1	1	1	2	1	7
NONE	OG0003217	1	1	2	1	1	1	7
NONE	OG0003218	1	1	2	1	1	1	7
NONE	OG0003219	1	1	2	1	1	1	7
NONE	OG0003220	1	1	2	1	1	1	7
NONE	OG0003221	1	1	2	1	1	1	7
NONE	OG0003222	1	1	2	1	1	1	7
NONE	OG0003223	1	1	2	1	1	1	7
NONE	OG0003224	1	1	2	1	1	1	7
NONE	OG0003225	1	0	3	1	0	2	7
NONE	OG0003226	1	2	1	1	1	1	7
NONE	OG0003227	2	1	1	1	1	1	7
NONE	OG0003228	2	1	1	1	1	1	7
NONE	OG0003229	1	1	1	2	1	1	7
NONE	OG0003230	1	1	4	0	0	1	7
NONE	OG0003231	1	1	1	2	1	1	7
NONE	OG0003232	1	1	2	1	1	1	7
NONE	OG0003233	1	1	2	2	0	1	7
NONE	OG0003234	1	1	1	2	1	1	7
NONE	OG0003235	1	1	1	2	1	1	7
NONE	OG0003236	1	1	1	2	1	1	7
NONE	OG0003237	1	1	2	1	1	1	7
NONE	OG0003238	1	2	1	1	1	1	7
NONE	OG0003239	1	1	1	1	1	2	7
NONE	OG0003240	1	1	2	1	1	1	7
NONE	OG0003241	1	1	1	2	1	1	7
NONE	OG0003242	2	1	1	1	1	1	7
NONE	OG0003243	1	1	1	2	1	1	7
NONE	OG0003244	1	1	1	2	1	1	7
NONE	OG0003245	1	1	1	2	1	1	7
NONE	OG0003246	1	1	1	2	1	1	7
NONE	OG0003247	1	2	1	1	1	1	7
NONE	OG0003248	1	1	1	1	2	1	7
NONE	OG0003249	1	1	2	1	1	1	7
NONE	OG0003250	1	1	2	1	1	1	7
NONE	OG0003251	1	1	1	2	1	1	7
NONE	OG0003252	2	0	2	2	0	1	7
NONE	OG0003253	1	1	1	2	1	1	7
NONE	OG0003254	1	1	1	1	2	1	7
NONE	OG0003255	1	0	5	0	1	0	7
NONE	OG0003256	1	1	2	1	1	1	7
NONE	OG0003257	1	1	1	2	1	1	7
NONE	OG0003258	1	2	1	1	0	2	7
NONE	OG0003259	1	0	3	0	0	3	7
NONE	OG0003260	1	1	1	2	1	1	7
NONE	OG0003261	1	1	1	2	1	1	7
NONE	OG0003262	1	1	1	2	1	1	7
NONE	OG0003263	1	1	1	2	1	1	7
NONE	OG0003264	1	1	1	2	1	1	7
NONE	OG0003265	1	1	1	2	1	1	7
NONE	OG0003266	1	1	1	2	1	1	7
NONE	OG0003267	1	0	1	2	0	3	7
NONE	OG0003268	1	1	1	2	1	1	7
NONE	OG0003269	2	1	1	1	1	1	7
NONE	OG0003270	2	1	1	1	1	1	7
NONE	OG0003271	1	1	3	1	0	1	7
NONE	OG0003272	2	1	1	1	1	1	7
NONE	OG0003273	1	0	1	1	3	1	7
NONE	OG0003274	1	1	1	1	2	1	7
NONE	OG0003275	3	0	1	2	0	1	7
NONE	OG0003276	1	1	2	1	1	1	7
NONE	OG0003277	1	1	1	1	2	1	7
NONE	OG0003278	1	2	1	1	1	1	7
NONE	OG0003279	1	1	2	1	1	1	7
NONE	OG0003280	1	2	1	1	1	1	7
NONE	OG0003281	1	1	2	1	1	1	7
NONE	OG0003282	1	0	2	1	1	2	7
NONE	OG0003283	1	1	2	1	1	1	7
NONE	OG0003284	1	1	2	1	1	1	7
NONE	OG0003285	1	1	2	1	1	1	7
NONE	OG0003286	1	3	1	1	0	1	7
NONE	OG0003287	1	1	1	2	1	1	7
NONE	OG0003288	1	1	2	1	1	1	7
NONE	OG0003289	1	0	6	0	0	0	7
NONE	OG0003290	1	0	6	0	0	0	7
NONE	OG0003291	1	2	1	1	1	1	7
NONE	OG0003292	1	1	2	1	1	1	7
NONE	OG0003293	1	1	2	1	0	2	7
NONE	OG0003294	1	1	1	1	2	1	7
NONE	OG0003295	1	1	2	1	1	1	7
NONE	OG0003296	1	0	4	1	0	1	7
NONE	OG0003297	1	1	1	2	1	1	7
NONE	OG0003298	2	1	1	1	1	1	7
NONE	OG0003299	2	1	1	1	1	1	7
NONE	OG0003300	2	0	3	1	0	1	7
NONE	OG0003301	1	1	2	1	1	1	7
NONE	OG0003302	1	1	2	1	1	1	7
NONE	OG0003303	1	1	2	1	1	1	7
NONE	OG0003304	1	1	2	1	1	1	7
NONE	OG0003305	1	1	1	1	1	2	7
NONE	OG0003306	1	1	2	1	1	1	7
NONE	OG0003307	2	1	1	1	1	1	7
NONE	OG0003308	1	1	1	2	1	1	7
NONE	OG0003309	1	1	2	1	1	1	7
NONE	OG0003310	2	1	1	1	1	1	7
NONE	OG0003311	1	2	1	2	0	1	7
NONE	OG0003312	2	1	1	1	1	1	7
NONE	OG0003313	3	1	2	0	0	1	7
NONE	OG0003314	2	1	1	1	1	1	7
NONE	OG0003315	2	1	1	1	1	1	7
NONE	OG0003316	1	1	1	1	2	1	7
NONE	OG0003317	2	1	1	1	1	1	7
NONE	OG0003318	2	1	1	1	1	1	7
NONE	OG0003319	2	1	1	1	1	1	7
NONE	OG0003320	2	1	1	1	1	1	7
NONE	OG0003321	2	1	1	1	1	1	7
NONE	OG0003322	2	1	1	1	1	1	7
NONE	OG0003323	2	1	1	1	1	1	7
NONE	OG0003324	2	1	1	1	1	1	7
NONE	OG0003325	2	1	1	1	1	1	7
NONE	OG0003326	1	1	1	2	1	1	7
NONE	OG0003327	2	1	1	1	1	1	7
NONE	OG0003328	2	1	1	1	1	1	7
NONE	OG0003329	2	1	1	1	1	1	7
NONE	OG0003330	1	1	1	2	0	2	7
NONE	OG0003331	2	1	1	1	1	1	7
NONE	OG0003332	2	1	1	1	1	1	7
NONE	OG0003333	1	1	2	1	1	1	7
NONE	OG0003334	2	1	1	1	1	1	7
NONE	OG0003335	1	1	1	2	1	1	7
NONE	OG0003336	1	1	1	2	1	1	7
NONE	OG0003337	1	2	1	1	1	1	7
NONE	OG0003338	1	0	1	1	0	4	7
NONE	OG0003339	1	1	1	1	1	2	7
NONE	OG0003340	2	1	1	1	1	1	7
NONE	OG0003341	2	1	1	1	1	1	7
NONE	OG0003342	1	1	2	1	1	1	7
NONE	OG0003343	1	1	1	1	2	1	7
NONE	OG0003344	2	0	3	1	0	1	7
NONE	OG0003345	2	1	1	1	1	1	7
NONE	OG0003346	2	1	1	1	1	1	7
NONE	OG0003347	2	1	1	1	1	1	7
NONE	OG0003348	1	1	2	1	1	1	7
NONE	OG0003349	1	1	2	1	1	1	7
NONE	OG0003350	1	1	2	1	1	1	7
NONE	OG0003351	1	1	2	1	1	1	7
NONE	OG0003352	1	1	2	1	1	1	7
NONE	OG0003353	1	1	2	1	1	1	7
NONE	OG0003354	1	1	2	1	1	1	7
NONE	OG0003355	1	1	2	1	1	1	7
NONE	OG0003356	1	1	2	1	1	1	7
NONE	OG0003357	1	2	1	1	1	1	7
NONE	OG0003358	1	1	1	2	1	1	7
NONE	OG0003359	1	1	1	1	2	1	7
NONE	OG0003360	2	1	1	1	1	1	7
NONE	OG0003361	2	1	1	1	1	1	7
NONE	OG0003362	1	1	1	1	2	1	7
NONE	OG0003363	1	1	2	2	0	1	7
NONE	OG0003364	1	1	1	1	1	2	7
NONE	OG0003365	1	1	1	2	1	1	7
NONE	OG0003366	1	1	1	1	2	1	7
NONE	OG0003367	1	1	2	1	1	1	7
NONE	OG0003368	2	1	1	1	1	1	7
NONE	OG0003369	2	1	1	2	1	0	7
NONE	OG0003370	1	1	1	2	1	1	7
NONE	OG0003371	2	1	1	1	1	1	7
NONE	OG0003372	2	1	1	1	1	1	7
NONE	OG0003373	2	1	1	1	1	1	7
NONE	OG0003374	1	1	1	2	1	1	7
NONE	OG0003375	1	2	1	1	1	1	7
NONE	OG0003376	1	1	2	1	1	1	7
NONE	OG0003377	1	2	1	1	1	1	7
NONE	OG0003378	1	1	2	1	1	1	7
NONE	OG0003379	1	2	1	1	1	1	7
NONE	OG0003380	2	1	1	1	1	1	7
NONE	OG0003381	2	1	1	1	1	1	7
NONE	OG0003382	1	2	1	1	1	1	7
NONE	OG0003383	2	1	1	1	1	1	7
NONE	OG0003384	1	1	2	1	1	1	7
NONE	OG0003385	1	1	1	2	1	1	7
NONE	OG0003386	2	3	0	2	0	0	7
NONE	OG0003387	1	1	1	1	1	2	7
NONE	OG0003388	1	0	3	1	1	1	7
NONE	OG0003389	1	1	1	2	1	1	7
NONE	OG0003390	1	1	1	1	1	2	7
NONE	OG0003391	1	2	1	1	1	1	7
NONE	OG0003392	1	1	3	1	1	0	7
NONE	OG0003393	1	1	1	2	1	1	7
NONE	OG0003394	1	1	1	2	1	1	7
NONE	OG0003395	2	1	2	1	0	1	7
NONE	OG0003396	1	1	3	1	0	1	7
NONE	OG0003397	1	1	2	1	1	1	7
NONE	OG0003398	1	1	2	1	1	1	7
NONE	OG0003399	1	0	1	4	0	1	7
NONE	OG0003400	1	1	2	1	1	1	7
NONE	OG0003401	1	1	1	1	1	2	7
NONE	OG0003402	1	2	1	1	1	1	7
NONE	OG0003403	1	2	1	1	1	1	7
NONE	OG0003404	1	2	1	1	1	1	7
NONE	OG0003405	1	1	1	2	1	1	7
NONE	OG0003406	1	1	1	2	1	1	7
NONE	OG0003407	2	1	1	1	1	1	7
NONE	OG0003408	1	1	1	1	2	1	7
NONE	OG0003409	1	1	1	1	2	1	7
NONE	OG0003410	1	1	1	2	1	1	7
NONE	OG0003411	1	1	1	2	1	1	7
NONE	OG0003412	1	1	1	2	1	1	7
NONE	OG0003413	1	1	2	1	1	1	7
NONE	OG0003414	1	1	2	1	1	1	7
NONE	OG0003415	2	1	1	1	1	1	7
NONE	OG0003416	2	1	1	1	1	1	7
NONE	OG0003417	1	1	2	1	1	1	7
NONE	OG0003418	1	1	2	1	1	1	7
NONE	OG0003419	1	1	2	1	1	1	7
NONE	OG0003420	1	1	2	1	1	1	7
NONE	OG0003421	1	1	2	1	1	1	7
NONE	OG0003422	1	1	2	1	1	1	7
NONE	OG0003423	1	1	3	1	0	1	7
NONE	OG0003424	1	0	3	1	1	1	7
NONE	OG0003425	1	1	2	1	1	1	7
NONE	OG0003426	1	1	1	1	2	1	7
NONE	OG0003427	1	1	1	1	2	1	7
NONE	OG0003428	1	1	1	1	2	1	7
NONE	OG0003429	1	1	1	2	1	1	7
NONE	OG0003430	2	1	1	1	1	1	7
NONE	OG0003431	2	1	1	1	1	1	7
NONE	OG0003432	1	1	1	2	1	1	7
NONE	OG0003433	1	1	1	2	1	1	7
NONE	OG0003434	2	1	1	1	1	1	7
NONE	OG0003435	2	1	1	1	1	1	7
NONE	OG0003436	1	1	1	2	1	1	7
NONE	OG0003437	1	1	1	1	2	1	7
NONE	OG0003438	1	1	1	1	2	1	7
NONE	OG0003439	1	1	1	1	1	2	7
NONE	OG0003440	1	1	1	1	2	1	7
NONE	OG0003441	1	1	1	2	1	1	7
NONE	OG0003442	1	1	1	1	2	1	7
NONE	OG0003443	2	1	1	1	1	1	7
NONE	OG0003444	1	1	1	2	1	1	7
NONE	OG0003445	1	1	2	1	0	2	7
NONE	OG0003446	1	1	1	2	1	1	7
NONE	OG0003447	1	1	1	2	1	1	7
NONE	OG0003448	1	1	1	2	1	1	7
NONE	OG0003449	1	2	1	1	1	1	7
NONE	OG0003450	1	1	1	2	1	1	7
NONE	OG0003451	1	2	1	1	1	1	7
NONE	OG0003452	1	1	1	2	1	1	7
NONE	OG0003453	1	1	1	2	1	1	7
NONE	OG0003454	1	1	1	2	1	1	7
NONE	OG0003455	1	2	1	1	1	1	7
NONE	OG0003456	1	1	1	1	2	1	7
NONE	OG0003457	1	1	2	1	1	1	7
NONE	OG0003458	1	1	1	1	2	1	7
NONE	OG0003459	0	1	1	2	1	2	7
NONE	OG0003460	0	2	1	1	2	1	7
NONE	OG0003461	0	1	2	2	0	2	7
NONE	OG0003462	0	1	1	2	2	1	7
NONE	OG0003463	0	6	0	1	0	0	7
NONE	OG0003464	0	1	3	1	1	1	7
NONE	OG0003465	0	1	3	1	1	1	7
NONE	OG0003466	0	1	0	5	0	1	7
NONE	OG0003467	0	1	1	1	1	3	7
NONE	OG0003468	0	1	1	3	1	1	7
NONE	OG0003469	0	0	2	0	4	1	7
NONE	OG0003470	0	0	7	0	0	0	7
NONE	OG0003471	0	0	2	1	0	4	7
NONE	OG0003472	0	0	7	0	0	0	7
NONE	OG0003473	0	0	5	2	0	0	7
NONE	OG0003474	0	0	2	1	0	4	7
NONE	OG0003475	0	0	6	0	0	1	7
NONE	OG0003476	0	0	6	0	0	1	7
NONE	OG0003477	0	0	5	0	0	2	7
NONE	OG0003478	0	0	7	0	0	0	7
NONE	OG0003479	0	0	1	4	1	1	7
NONE	OG0003480	0	0	1	0	0	6	7
NONE	OG0003481	0	0	7	0	0	0	7
NONE	OG0003482	0	0	1	3	0	3	7
NONE	OG0003483	0	0	7	0	0	0	7
NONE	OG0003484	0	0	5	2	0	0	7
NONE	OG0003485	0	0	5	0	0	2	7
NONE	OG0003486	0	0	3	0	0	4	7
NONE	OG0003487	0	0	1	0	4	2	7
NONE	OG0003488	0	0	4	0	0	3	7
NONE	OG0003489	0	0	7	0	0	0	7
NONE	OG0003490	0	0	3	1	0	3	7
NONE	OG0003491	0	0	1	0	0	6	7
NONE	OG0003492	0	0	2	0	0	5	7
NONE	OG0003493	0	0	0	7	0	0	7
NONE	OG0003494	0	0	0	7	0	0	7
NONE	OG0003495	0	0	0	7	0	0	7
NONE	OG0003496	0	0	0	7	0	0	7
NONE	OG0003497	0	0	0	7	0	0	7
NONE	OG0003498	0	0	0	7	0	0	7
NONE	OG0003499	0	0	0	7	0	0	7
NONE	OG0003500	0	0	0	7	0	0	7
NONE	OG0003501	0	0	0	7	0	0	7
NONE	OG0003502	0	0	0	1	6	0	7
NONE	OG0003503	0	0	0	6	0	1	7
NONE	OG0003504	0	0	0	7	0	0	7
NONE	OG0003505	0	0	0	7	0	0	7
NONE	OG0003506	0	0	0	0	7	0	7
NONE	OG0003507	0	0	0	0	7	0	7
NONE	OG0003508	0	0	0	0	7	0	7
NONE	OG0003509	0	0	0	0	7	0	7
NONE	OG0003510	0	0	0	0	7	0	7
NONE	OG0003511	0	0	0	0	7	0	7
NONE	OG0003512	0	0	0	0	7	0	7
NONE	OG0003513	0	0	0	0	6	1	7
NONE	OG0003514	0	0	0	0	7	0	7
NONE	OG0003515	0	0	0	0	0	7	7
NONE	OG0003516	0	0	0	0	0	7	7
NONE	OG0003517	0	0	0	0	0	7	7
NONE	OG0003518	0	0	0	0	0	7	7
NONE	OG0003519	1	0	0	5	0	0	6
NONE	OG0003520	1	1	1	1	1	1	6
NONE	OG0003521	1	1	1	1	0	2	6
NONE	OG0003522	2	1	1	1	0	1	6
NONE	OG0003523	1	1	1	1	1	1	6
NONE	OG0003524	2	0	1	1	1	1	6
NONE	OG0003525	2	0	1	1	1	1	6
NONE	OG0003526	1	1	1	1	1	1	6
NONE	OG0003527	1	1	1	1	1	1	6
NONE	OG0003528	1	1	1	1	1	1	6
NONE	OG0003529	1	1	1	1	1	1	6
NONE	OG0003530	2	1	0	1	1	1	6
NONE	OG0003531	1	1	1	1	1	1	6
NONE	OG0003532	1	1	1	1	1	1	6
NONE	OG0003533	1	1	1	1	1	1	6
NONE	OG0003534	1	1	1	1	1	1	6
NONE	OG0003535	1	1	1	1	1	1	6
NONE	OG0003536	1	1	1	1	1	1	6
NONE	OG0003537	1	1	1	1	1	1	6
NONE	OG0003538	1	1	1	1	1	1	6
NONE	OG0003539	1	1	1	1	1	1	6
NONE	OG0003540	1	1	1	1	1	1	6
NONE	OG0003541	1	1	1	1	1	1	6
NONE	OG0003542	1	1	1	1	1	1	6
NONE	OG0003543	1	1	1	1	1	1	6
NONE	OG0003544	1	1	1	1	1	1	6
NONE	OG0003545	1	1	1	1	1	1	6
NONE	OG0003546	1	1	1	1	1	1	6
NONE	OG0003547	1	1	1	1	1	1	6
NONE	OG0003548	1	1	1	1	1	1	6
NONE	OG0003549	1	1	1	1	1	1	6
NONE	OG0003550	1	1	1	1	1	1	6
NONE	OG0003551	1	0	1	2	1	1	6
NONE	OG0003552	1	0	1	2	1	1	6
NONE	OG0003553	1	1	1	1	1	1	6
NONE	OG0003554	1	1	1	1	1	1	6
NONE	OG0003555	1	1	1	1	1	1	6
NONE	OG0003556	1	1	1	1	1	1	6
NONE	OG0003557	1	1	1	1	1	1	6
NONE	OG0003558	1	1	1	1	1	1	6
NONE	OG0003559	1	1	1	1	1	1	6
NONE	OG0003560	1	1	1	1	1	1	6
NONE	OG0003561	1	1	1	1	1	1	6
NONE	OG0003562	1	1	1	1	1	1	6
NONE	OG0003563	1	1	1	1	1	1	6
NONE	OG0003564	3	0	2	0	0	1	6
NONE	OG0003565	1	1	1	1	1	1	6
NONE	OG0003566	1	1	1	1	1	1	6
NONE	OG0003567	1	1	1	1	1	1	6
NONE	OG0003568	1	1	1	1	1	1	6
NONE	OG0003569	1	1	1	1	1	1	6
NONE	OG0003570	1	1	1	1	1	1	6
NONE	OG0003571	1	1	1	1	1	1	6
NONE	OG0003572	1	1	1	1	1	1	6
NONE	OG0003573	1	1	1	1	1	1	6
NONE	OG0003574	1	1	1	1	1	1	6
NONE	OG0003575	1	1	1	1	1	1	6
NONE	OG0003576	2	0	1	1	1	1	6
NONE	OG0003577	1	1	1	1	1	1	6
NONE	OG0003578	1	1	1	1	1	1	6
NONE	OG0003579	1	1	1	1	1	1	6
NONE	OG0003580	1	1	1	1	1	1	6
NONE	OG0003581	1	1	1	1	1	1	6
NONE	OG0003582	1	1	1	1	1	1	6
NONE	OG0003583	1	1	1	1	1	1	6
NONE	OG0003584	1	1	1	1	1	1	6
NONE	OG0003585	1	1	1	1	1	1	6
NONE	OG0003586	1	1	1	1	1	1	6
NONE	OG0003587	1	1	1	1	1	1	6
NONE	OG0003588	1	1	1	1	1	1	6
NONE	OG0003589	1	1	1	1	1	1	6
NONE	OG0003590	1	0	1	2	1	1	6
NONE	OG0003591	1	1	1	1	1	1	6
NONE	OG0003592	1	1	1	1	1	1	6
NONE	OG0003593	1	1	1	1	1	1	6
NONE	OG0003594	1	1	1	1	1	1	6
NONE	OG0003595	1	1	1	1	1	1	6
NONE	OG0003596	1	1	1	1	1	1	6
NONE	OG0003597	1	1	1	1	1	1	6
NONE	OG0003598	1	1	1	1	1	1	6
NONE	OG0003599	1	1	1	1	1	1	6
NONE	OG0003600	1	1	1	1	1	1	6
NONE	OG0003601	1	1	1	1	1	1	6
NONE	OG0003602	1	1	2	0	1	1	6
NONE	OG0003603	1	1	1	1	1	1	6
NONE	OG0003604	1	1	2	1	0	1	6
NONE	OG0003605	1	1	1	1	1	1	6
NONE	OG0003606	1	1	1	1	1	1	6
NONE	OG0003607	1	1	1	1	1	1	6
NONE	OG0003608	4	0	2	0	0	0	6
NONE	OG0003609	1	1	1	1	1	1	6
NONE	OG0003610	1	1	1	1	1	1	6
NONE	OG0003611	1	1	1	1	1	1	6
NONE	OG0003612	1	1	1	1	1	1	6
NONE	OG0003613	1	1	1	1	1	1	6
NONE	OG0003614	1	1	1	1	1	1	6
NONE	OG0003615	1	1	1	1	1	1	6
NONE	OG0003616	1	1	1	1	1	1	6
NONE	OG0003617	1	1	1	1	1	1	6
NONE	OG0003618	1	1	1	1	1	1	6
NONE	OG0003619	1	1	1	1	1	1	6
NONE	OG0003620	1	1	1	2	0	1	6
NONE	OG0003621	1	1	1	1	1	1	6
NONE	OG0003622	1	1	1	1	1	1	6
NONE	OG0003623	1	0	2	1	1	1	6
NONE	OG0003624	1	1	1	1	1	1	6
NONE	OG0003625	1	1	1	1	1	1	6
NONE	OG0003626	1	1	1	1	1	1	6
NONE	OG0003627	2	1	0	1	1	1	6
NONE	OG0003628	1	1	1	1	1	1	6
NONE	OG0003629	1	1	1	1	1	1	6
NONE	OG0003630	1	1	1	1	1	1	6
NONE	OG0003631	1	1	1	1	1	1	6
NONE	OG0003632	1	1	1	1	1	1	6
NONE	OG0003633	1	0	1	1	2	1	6
NONE	OG0003634	1	0	1	1	2	1	6
NONE	OG0003635	1	1	1	1	1	1	6
NONE	OG0003636	1	1	1	1	1	1	6
NONE	OG0003637	1	1	1	1	1	1	6
NONE	OG0003638	1	1	1	1	1	1	6
NONE	OG0003639	1	1	1	1	1	1	6
NONE	OG0003640	1	1	1	1	1	1	6
NONE	OG0003641	1	1	1	1	1	1	6
NONE	OG0003642	1	1	1	1	1	1	6
NONE	OG0003643	1	1	1	1	1	1	6
NONE	OG0003644	1	1	1	1	1	1	6
NONE	OG0003645	1	1	1	1	1	1	6
NONE	OG0003646	1	1	1	1	1	1	6
NONE	OG0003647	1	1	1	1	1	1	6
NONE	OG0003648	1	1	1	1	1	1	6
NONE	OG0003649	1	1	1	1	1	1	6
NONE	OG0003650	1	1	1	1	1	1	6
NONE	OG0003651	1	1	1	1	1	1	6
NONE	OG0003652	1	1	1	1	1	1	6
NONE	OG0003653	1	1	1	1	1	1	6
NONE	OG0003654	1	1	1	1	1	1	6
NONE	OG0003655	1	1	1	1	1	1	6
NONE	OG0003656	1	1	1	1	1	1	6
NONE	OG0003657	1	0	1	3	0	1	6
NONE	OG0003658	1	1	1	1	1	1	6
NONE	OG0003659	5	0	1	0	0	0	6
NONE	OG0003660	1	1	1	1	1	1	6
NONE	OG0003661	1	1	1	1	1	1	6
NONE	OG0003662	1	1	1	1	1	1	6
NONE	OG0003663	1	1	1	1	1	1	6
NONE	OG0003664	1	1	1	1	1	1	6
NONE	OG0003665	1	1	1	1	1	1	6
NONE	OG0003666	1	1	1	1	1	1	6
NONE	OG0003667	1	1	1	1	1	1	6
NONE	OG0003668	1	1	1	1	1	1	6
NONE	OG0003669	1	1	1	1	1	1	6
NONE	OG0003670	1	1	1	1	1	1	6
NONE	OG0003671	1	1	1	1	1	1	6
NONE	OG0003672	1	1	1	1	1	1	6
NONE	OG0003673	1	1	1	1	1	1	6
NONE	OG0003674	1	1	1	1	1	1	6
NONE	OG0003675	1	1	1	1	1	1	6
NONE	OG0003676	1	1	1	1	1	1	6
NONE	OG0003677	1	1	1	1	1	1	6
NONE	OG0003678	1	1	1	1	1	1	6
NONE	OG0003679	1	1	1	1	1	1	6
NONE	OG0003680	1	1	1	1	1	1	6
NONE	OG0003681	1	1	1	1	1	1	6
NONE	OG0003682	1	1	1	1	1	1	6
NONE	OG0003683	1	0	2	1	1	1	6
NONE	OG0003684	1	1	1	1	1	1	6
NONE	OG0003685	1	1	1	1	1	1	6
NONE	OG0003686	1	1	1	1	1	1	6
NONE	OG0003687	1	1	1	1	1	1	6
NONE	OG0003688	1	1	1	1	1	1	6
NONE	OG0003689	1	1	1	1	1	1	6
NONE	OG0003690	1	1	1	1	1	1	6
NONE	OG0003691	1	1	1	1	1	1	6
NONE	OG0003692	1	1	1	1	1	1	6
NONE	OG0003693	1	1	1	1	1	1	6
NONE	OG0003694	1	1	1	1	1	1	6
NONE	OG0003695	1	1	1	1	1	1	6
NONE	OG0003696	1	1	1	1	1	1	6
NONE	OG0003697	1	1	1	1	1	1	6
NONE	OG0003698	1	1	1	1	1	1	6
NONE	OG0003699	1	1	1	1	1	1	6
NONE	OG0003700	1	1	1	1	1	1	6
NONE	OG0003701	1	1	1	1	1	1	6
NONE	OG0003702	1	1	1	1	1	1	6
NONE	OG0003703	1	1	1	1	1	1	6
NONE	OG0003704	1	1	1	1	1	1	6
NONE	OG0003705	1	1	1	1	1	1	6
NONE	OG0003706	1	1	1	1	1	1	6
NONE	OG0003707	1	0	1	2	1	1	6
NONE	OG0003708	2	0	2	1	0	1	6
NONE	OG0003709	3	0	2	0	0	1	6
NONE	OG0003710	1	0	2	1	1	1	6
NONE	OG0003711	1	0	2	1	1	1	6
NONE	OG0003712	1	1	1	1	1	1	6
NONE	OG0003713	1	1	1	1	1	1	6
NONE	OG0003714	1	1	1	1	1	1	6
NONE	OG0003715	2	1	1	0	1	1	6
NONE	OG0003716	1	1	1	1	1	1	6
NONE	OG0003717	1	1	1	1	1	1	6
NONE	OG0003718	2	0	2	1	0	1	6
NONE	OG0003719	1	1	1	1	1	1	6
NONE	OG0003720	1	1	1	1	1	1	6
NONE	OG0003721	1	1	1	1	1	1	6
NONE	OG0003722	1	1	1	1	1	1	6
NONE	OG0003723	1	1	1	1	1	1	6
NONE	OG0003724	1	1	1	1	1	1	6
NONE	OG0003725	1	1	1	1	1	1	6
NONE	OG0003726	1	1	1	1	1	1	6
NONE	OG0003727	1	1	1	1	1	1	6
NONE	OG0003728	1	1	1	1	1	1	6
NONE	OG0003729	1	1	1	1	1	1	6
NONE	OG0003730	1	1	1	1	1	1	6
NONE	OG0003731	1	1	1	1	1	1	6
NONE	OG0003732	1	1	1	1	1	1	6
NONE	OG0003733	1	1	1	1	1	1	6
NONE	OG0003734	1	1	1	1	1	1	6
NONE	OG0003735	1	1	1	2	0	1	6
NONE	OG0003736	1	1	1	2	0	1	6
NONE	OG0003737	1	1	1	1	1	1	6
NONE	OG0003738	1	1	1	1	1	1	6
NONE	OG0003739	1	1	1	1	1	1	6
NONE	OG0003740	1	0	2	1	1	1	6
NONE	OG0003741	2	0	1	1	0	2	6
NONE	OG0003742	1	0	2	2	0	1	6
NONE	OG0003743	1	1	1	1	1	1	6
NONE	OG0003744	1	1	1	1	1	1	6
NONE	OG0003745	1	1	1	1	1	1	6
NONE	OG0003746	1	1	1	1	1	1	6
NONE	OG0003747	1	1	1	1	1	1	6
NONE	OG0003748	1	1	1	1	1	1	6
NONE	OG0003749	1	1	1	1	1	1	6
NONE	OG0003750	1	1	1	1	1	1	6
NONE	OG0003751	1	1	1	1	1	1	6
NONE	OG0003752	1	1	1	1	1	1	6
NONE	OG0003753	1	1	1	1	1	1	6
NONE	OG0003754	1	1	1	1	1	1	6
NONE	OG0003755	1	1	1	1	1	1	6
NONE	OG0003756	1	1	1	1	1	1	6
NONE	OG0003757	1	1	1	1	1	1	6
NONE	OG0003758	1	1	1	1	1	1	6
NONE	OG0003759	1	1	1	1	1	1	6
NONE	OG0003760	1	1	1	1	1	1	6
NONE	OG0003761	1	1	1	1	1	1	6
NONE	OG0003762	1	1	1	1	1	1	6
NONE	OG0003763	1	1	1	1	1	1	6
NONE	OG0003764	1	1	1	1	1	1	6
NONE	OG0003765	1	1	1	1	1	1	6
NONE	OG0003766	1	1	1	1	1	1	6
NONE	OG0003767	1	1	1	1	1	1	6
NONE	OG0003768	1	1	1	1	1	1	6
NONE	OG0003769	1	1	1	1	1	1	6
NONE	OG0003770	1	1	1	1	1	1	6
NONE	OG0003771	1	1	1	1	1	1	6
NONE	OG0003772	1	1	1	1	1	1	6
NONE	OG0003773	1	1	1	1	1	1	6
NONE	OG0003774	1	1	1	1	1	1	6
NONE	OG0003775	1	1	1	1	1	1	6
NONE	OG0003776	1	1	1	1	1	1	6
NONE	OG0003777	1	1	1	1	1	1	6
NONE	OG0003778	1	0	2	1	1	1	6
NONE	OG0003779	1	1	1	1	1	1	6
NONE	OG0003780	5	0	0	0	0	1	6
NONE	OG0003781	1	1	1	1	1	1	6
NONE	OG0003782	1	1	1	1	1	1	6
NONE	OG0003783	1	1	1	1	1	1	6
NONE	OG0003784	2	0	1	2	0	1	6
NONE	OG0003785	1	1	1	1	1	1	6
NONE	OG0003786	1	1	1	1	1	1	6
NONE	OG0003787	1	1	1	1	1	1	6
NONE	OG0003788	1	1	1	1	1	1	6
NONE	OG0003789	1	1	1	1	1	1	6
NONE	OG0003790	1	1	1	1	1	1	6
NONE	OG0003791	1	1	1	1	1	1	6
NONE	OG0003792	1	1	1	1	1	1	6
NONE	OG0003793	1	1	1	1	1	1	6
NONE	OG0003794	1	1	1	1	1	1	6
NONE	OG0003795	1	1	1	1	1	1	6
NONE	OG0003796	1	1	1	1	1	1	6
NONE	OG0003797	1	1	1	1	1	1	6
NONE	OG0003798	1	1	1	1	1	1	6
NONE	OG0003799	1	1	1	1	1	1	6
NONE	OG0003800	1	1	1	1	1	1	6
NONE	OG0003801	1	1	1	1	1	1	6
NONE	OG0003802	1	1	1	1	1	1	6
NONE	OG0003803	1	1	1	1	1	1	6
NONE	OG0003804	1	1	1	1	1	1	6
NONE	OG0003805	1	1	1	1	1	1	6
NONE	OG0003806	1	1	1	1	1	1	6
NONE	OG0003807	1	1	1	1	1	1	6
NONE	OG0003808	1	1	1	1	1	1	6
NONE	OG0003809	1	1	1	1	1	1	6
NONE	OG0003810	1	1	1	1	1	1	6
NONE	OG0003811	1	1	1	1	1	1	6
NONE	OG0003812	1	1	1	1	1	1	6
NONE	OG0003813	1	1	1	1	1	1	6
NONE	OG0003814	1	0	2	1	1	1	6
NONE	OG0003815	2	0	1	1	1	1	6
NONE	OG0003816	1	1	1	1	1	1	6
NONE	OG0003817	1	1	1	1	1	1	6
NONE	OG0003818	1	1	1	1	1	1	6
NONE	OG0003819	6	0	0	0	0	0	6
NONE	OG0003820	1	1	1	2	1	0	6
NONE	OG0003821	1	1	1	1	1	1	6
NONE	OG0003822	1	1	1	1	1	1	6
NONE	OG0003823	1	1	1	1	1	1	6
NONE	OG0003824	1	1	1	1	1	1	6
NONE	OG0003825	1	1	1	1	1	1	6
NONE	OG0003826	1	1	1	1	1	1	6
NONE	OG0003827	1	1	1	1	1	1	6
NONE	OG0003828	1	1	1	1	1	1	6
NONE	OG0003829	1	1	1	1	1	1	6
NONE	OG0003830	1	1	1	1	1	1	6
NONE	OG0003831	1	1	1	1	1	1	6
NONE	OG0003832	6	0	0	0	0	0	6
NONE	OG0003833	1	1	1	1	1	1	6
NONE	OG0003834	1	1	1	1	1	1	6
NONE	OG0003835	1	1	1	1	1	1	6
NONE	OG0003836	1	1	1	1	1	1	6
NONE	OG0003837	1	1	1	1	1	1	6
NONE	OG0003838	1	1	1	1	1	1	6
NONE	OG0003839	1	1	1	1	1	1	6
NONE	OG0003840	1	1	1	1	1	1	6
NONE	OG0003841	1	1	1	1	1	1	6
NONE	OG0003842	1	1	1	1	1	1	6
NONE	OG0003843	1	1	1	1	1	1	6
NONE	OG0003844	1	1	1	1	1	1	6
NONE	OG0003845	1	1	1	1	1	1	6
NONE	OG0003846	1	1	1	1	1	1	6
NONE	OG0003847	1	1	1	1	1	1	6
NONE	OG0003848	1	1	1	1	1	1	6
NONE	OG0003849	1	1	1	1	1	1	6
NONE	OG0003850	1	1	1	1	1	1	6
NONE	OG0003851	1	1	1	1	1	1	6
NONE	OG0003852	2	0	2	1	0	1	6
NONE	OG0003853	1	1	1	1	1	1	6
NONE	OG0003854	1	1	1	1	1	1	6
NONE	OG0003855	1	1	1	1	1	1	6
NONE	OG0003856	1	1	1	1	1	1	6
NONE	OG0003857	1	1	1	1	1	1	6
NONE	OG0003858	1	1	1	1	1	1	6
NONE	OG0003859	1	1	1	1	1	1	6
NONE	OG0003860	1	1	1	1	1	1	6
NONE	OG0003861	1	1	1	2	0	1	6
NONE	OG0003862	1	1	1	1	1	1	6
NONE	OG0003863	1	1	1	1	1	1	6
NONE	OG0003864	1	1	1	1	1	1	6
NONE	OG0003865	1	1	1	1	1	1	6
NONE	OG0003866	1	1	1	1	1	1	6
NONE	OG0003867	1	1	1	1	1	1	6
NONE	OG0003868	1	1	1	1	1	1	6
NONE	OG0003869	6	0	0	0	0	0	6
NONE	OG0003870	1	1	1	1	1	1	6
NONE	OG0003871	1	1	1	1	1	1	6
NONE	OG0003872	1	1	1	1	1	1	6
NONE	OG0003873	1	1	1	1	1	1	6
NONE	OG0003874	1	0	2	1	1	1	6
NONE	OG0003875	1	0	2	1	1	1	6
NONE	OG0003876	1	0	2	1	1	1	6
NONE	OG0003877	1	1	1	1	1	1	6
NONE	OG0003878	1	1	1	1	1	1	6
NONE	OG0003879	1	1	1	1	1	1	6
NONE	OG0003880	1	1	1	1	1	1	6
NONE	OG0003881	1	1	1	1	1	1	6
NONE	OG0003882	1	1	1	1	1	1	6
NONE	OG0003883	1	1	1	1	1	1	6
NONE	OG0003884	1	1	1	1	1	1	6
NONE	OG0003885	1	1	1	1	1	1	6
NONE	OG0003886	1	1	1	1	1	1	6
NONE	OG0003887	1	1	1	1	1	1	6
NONE	OG0003888	4	0	2	0	0	0	6
NONE	OG0003889	1	1	1	1	1	1	6
NONE	OG0003890	1	1	1	1	1	1	6
NONE	OG0003891	1	0	1	2	1	1	6
NONE	OG0003892	1	0	1	2	1	1	6
NONE	OG0003893	1	1	1	1	1	1	6
NONE	OG0003894	2	0	1	1	1	1	6
NONE	OG0003895	2	1	1	1	0	1	6
NONE	OG0003896	1	1	1	1	1	1	6
NONE	OG0003897	1	1	1	1	1	1	6
NONE	OG0003898	1	1	1	1	1	1	6
NONE	OG0003899	1	1	1	1	1	1	6
NONE	OG0003900	1	1	1	1	1	1	6
NONE	OG0003901	1	1	1	1	1	1	6
NONE	OG0003902	1	1	1	1	1	1	6
NONE	OG0003903	1	1	1	1	1	1	6
NONE	OG0003904	1	1	1	1	1	1	6
NONE	OG0003905	6	0	0	0	0	0	6
NONE	OG0003906	1	1	1	1	1	1	6
NONE	OG0003907	1	1	1	1	1	1	6
NONE	OG0003908	1	1	1	1	1	1	6
NONE	OG0003909	1	1	1	1	1	1	6
NONE	OG0003910	2	1	1	1	0	1	6
NONE	OG0003911	1	1	1	1	1	1	6
NONE	OG0003912	1	1	1	1	1	1	6
NONE	OG0003913	1	1	1	1	1	1	6
NONE	OG0003914	1	1	1	1	1	1	6
NONE	OG0003915	1	1	1	1	1	1	6
NONE	OG0003916	1	1	1	1	1	1	6
NONE	OG0003917	1	1	1	1	1	1	6
NONE	OG0003918	1	1	1	1	1	1	6
NONE	OG0003919	1	1	1	1	1	1	6
NONE	OG0003920	1	1	1	1	1	1	6
NONE	OG0003921	1	1	1	1	1	1	6
NONE	OG0003922	1	1	1	1	1	1	6
NONE	OG0003923	1	1	1	1	1	1	6
NONE	OG0003924	1	1	1	1	1	1	6
NONE	OG0003925	6	0	0	0	0	0	6
NONE	OG0003926	1	1	1	1	1	1	6
NONE	OG0003927	1	0	0	3	0	2	6
NONE	OG0003928	1	1	2	1	0	1	6
NONE	OG0003929	1	1	1	1	1	1	6
NONE	OG0003930	1	1	1	1	1	1	6
NONE	OG0003931	1	1	1	1	1	1	6
NONE	OG0003932	1	1	1	1	1	1	6
NONE	OG0003933	1	0	2	1	1	1	6
NONE	OG0003934	1	1	1	1	1	1	6
NONE	OG0003935	1	1	1	1	1	1	6
NONE	OG0003936	1	1	1	1	1	1	6
NONE	OG0003937	1	1	1	1	1	1	6
NONE	OG0003938	1	1	1	1	1	1	6
NONE	OG0003939	1	1	1	1	1	1	6
NONE	OG0003940	1	1	1	2	0	1	6
NONE	OG0003941	1	1	1	2	0	1	6
NONE	OG0003942	1	1	1	1	1	1	6
NONE	OG0003943	1	1	1	1	1	1	6
NONE	OG0003944	1	1	1	1	1	1	6
NONE	OG0003945	1	1	1	1	1	1	6
NONE	OG0003946	1	1	1	1	1	1	6
NONE	OG0003947	1	1	1	1	1	1	6
NONE	OG0003948	1	1	1	1	1	1	6
NONE	OG0003949	1	1	1	1	1	1	6
NONE	OG0003950	1	1	1	1	1	1	6
NONE	OG0003951	1	1	1	1	1	1	6
NONE	OG0003952	1	1	1	1	1	1	6
NONE	OG0003953	1	1	1	1	1	1	6
NONE	OG0003954	1	1	1	1	1	1	6
NONE	OG0003955	1	1	1	1	1	1	6
NONE	OG0003956	1	0	2	1	1	1	6
NONE	OG0003957	1	1	1	1	1	1	6
NONE	OG0003958	1	0	1	2	1	1	6
NONE	OG0003959	1	1	1	1	1	1	6
NONE	OG0003960	1	1	1	1	1	1	6
NONE	OG0003961	1	1	1	1	1	1	6
NONE	OG0003962	1	1	1	1	1	1	6
NONE	OG0003963	1	1	1	1	1	1	6
NONE	OG0003964	1	0	2	1	1	1	6
NONE	OG0003965	1	1	1	1	1	1	6
NONE	OG0003966	1	1	1	1	1	1	6
NONE	OG0003967	1	1	1	1	1	1	6
NONE	OG0003968	1	1	1	1	1	1	6
NONE	OG0003969	1	1	1	1	1	1	6
NONE	OG0003970	1	1	1	1	1	1	6
NONE	OG0003971	1	1	1	1	1	1	6
NONE	OG0003972	1	1	1	1	1	1	6
NONE	OG0003973	1	1	1	1	1	1	6
NONE	OG0003974	1	1	1	1	1	1	6
NONE	OG0003975	2	1	2	1	0	0	6
NONE	OG0003976	1	1	1	1	1	1	6
NONE	OG0003977	1	1	1	1	1	1	6
NONE	OG0003978	1	1	1	1	1	1	6
NONE	OG0003979	1	1	1	1	1	1	6
NONE	OG0003980	1	0	1	2	1	1	6
NONE	OG0003981	1	0	1	2	1	1	6
NONE	OG0003982	1	1	1	1	1	1	6
NONE	OG0003983	1	1	1	1	1	1	6
NONE	OG0003984	1	1	1	1	1	1	6
NONE	OG0003985	1	1	1	1	1	1	6
NONE	OG0003986	1	1	1	1	1	1	6
NONE	OG0003987	1	1	1	1	1	1	6
NONE	OG0003988	1	1	1	1	1	1	6
NONE	OG0003989	1	1	1	1	1	1	6
NONE	OG0003990	1	1	1	1	1	1	6
NONE	OG0003991	1	1	1	1	1	1	6
NONE	OG0003992	6	0	0	0	0	0	6
NONE	OG0003993	1	1	1	1	1	1	6
NONE	OG0003994	1	1	1	1	1	1	6
NONE	OG0003995	1	1	1	1	1	1	6
NONE	OG0003996	1	1	1	1	1	1	6
NONE	OG0003997	1	1	1	1	1	1	6
NONE	OG0003998	1	1	1	1	1	1	6
NONE	OG0003999	1	1	1	1	1	1	6
NONE	OG0004000	1	1	1	1	1	1	6
NONE	OG0004001	1	1	1	1	1	1	6
NONE	OG0004002	1	1	1	1	1	1	6
NONE	OG0004003	1	1	1	1	1	1	6
NONE	OG0004004	1	1	1	1	1	1	6
NONE	OG0004005	3	0	3	0	0	0	6
NONE	OG0004006	1	1	1	1	1	1	6
NONE	OG0004007	1	1	1	1	1	1	6
NONE	OG0004008	1	1	1	1	1	1	6
NONE	OG0004009	1	0	1	2	1	1	6
NONE	OG0004010	1	1	1	2	1	0	6
NONE	OG0004011	1	1	1	1	1	1	6
NONE	OG0004012	1	1	1	1	1	1	6
NONE	OG0004013	1	1	1	1	1	1	6
NONE	OG0004014	2	0	1	1	1	1	6
NONE	OG0004015	1	1	1	1	1	1	6
NONE	OG0004016	1	1	1	1	1	1	6
NONE	OG0004017	1	1	1	1	1	1	6
NONE	OG0004018	1	1	1	1	1	1	6
NONE	OG0004019	1	1	1	1	1	1	6
NONE	OG0004020	1	1	1	1	1	1	6
NONE	OG0004021	1	1	1	1	1	1	6
NONE	OG0004022	1	1	1	1	1	1	6
NONE	OG0004023	1	1	1	1	1	1	6
NONE	OG0004024	1	1	1	1	1	1	6
NONE	OG0004025	1	1	1	1	1	1	6
NONE	OG0004026	1	1	1	1	1	1	6
NONE	OG0004027	1	0	1	1	1	2	6
NONE	OG0004028	1	1	1	1	1	1	6
NONE	OG0004029	1	1	1	1	1	1	6
NONE	OG0004030	1	1	1	1	1	1	6
NONE	OG0004031	1	1	1	1	1	1	6
NONE	OG0004032	1	1	1	1	1	1	6
NONE	OG0004033	1	1	1	1	1	1	6
NONE	OG0004034	1	1	1	1	1	1	6
NONE	OG0004035	1	1	1	1	1	1	6
NONE	OG0004036	1	1	1	1	1	1	6
NONE	OG0004037	1	1	1	1	1	1	6
NONE	OG0004038	1	1	1	1	1	1	6
NONE	OG0004039	1	1	1	1	1	1	6
NONE	OG0004040	1	1	1	1	1	1	6
NONE	OG0004041	1	1	1	1	1	1	6
NONE	OG0004042	1	1	1	1	1	1	6
NONE	OG0004043	1	1	1	1	1	1	6
NONE	OG0004044	1	1	1	1	1	1	6
NONE	OG0004045	1	1	1	1	1	1	6
NONE	OG0004046	1	1	1	1	1	1	6
NONE	OG0004047	1	1	1	1	1	1	6
NONE	OG0004048	1	1	1	1	1	1	6
NONE	OG0004049	1	0	1	3	0	1	6
NONE	OG0004050	1	1	1	1	1	1	6
NONE	OG0004051	1	1	1	1	1	1	6
NONE	OG0004052	1	1	1	1	1	1	6
NONE	OG0004053	1	1	1	1	1	1	6
NONE	OG0004054	1	1	1	1	1	1	6
NONE	OG0004055	1	1	1	1	1	1	6
NONE	OG0004056	1	1	1	1	1	1	6
NONE	OG0004057	1	1	1	0	1	2	6
NONE	OG0004058	6	0	0	0	0	0	6
NONE	OG0004059	1	1	1	1	1	1	6
NONE	OG0004060	1	1	1	1	1	1	6
NONE	OG0004061	1	1	1	1	1	1	6
NONE	OG0004062	1	1	1	1	1	1	6
NONE	OG0004063	1	1	1	1	1	1	6
NONE	OG0004064	1	1	1	1	1	1	6
NONE	OG0004065	1	1	1	1	1	1	6
NONE	OG0004066	1	1	1	1	1	1	6
NONE	OG0004067	1	1	1	1	1	1	6
NONE	OG0004068	1	1	1	1	1	1	6
NONE	OG0004069	1	1	1	1	1	1	6
NONE	OG0004070	1	1	1	1	1	1	6
NONE	OG0004071	1	1	1	1	1	1	6
NONE	OG0004072	1	1	1	1	1	1	6
NONE	OG0004073	1	1	1	1	1	1	6
NONE	OG0004074	1	1	1	1	1	1	6
NONE	OG0004075	1	1	1	1	1	1	6
NONE	OG0004076	1	1	1	1	1	1	6
NONE	OG0004077	1	1	1	1	1	1	6
NONE	OG0004078	1	1	1	1	1	1	6
NONE	OG0004079	1	1	1	1	1	1	6
NONE	OG0004080	1	1	1	1	1	1	6
NONE	OG0004081	1	1	1	1	1	1	6
NONE	OG0004082	1	1	1	1	1	1	6
NONE	OG0004083	1	1	1	1	1	1	6
NONE	OG0004084	1	1	1	1	1	1	6
NONE	OG0004085	6	0	0	0	0	0	6
NONE	OG0004086	2	0	1	1	1	1	6
NONE	OG0004087	2	1	1	1	0	1	6
NONE	OG0004088	1	1	1	1	1	1	6
NONE	OG0004089	1	1	2	1	0	1	6
NONE	OG0004090	1	1	1	1	1	1	6
NONE	OG0004091	6	0	0	0	0	0	6
NONE	OG0004092	1	1	1	1	1	1	6
NONE	OG0004093	1	1	1	1	1	1	6
NONE	OG0004094	1	1	1	1	1	1	6
NONE	OG0004095	1	1	1	1	1	1	6
NONE	OG0004096	1	0	2	1	1	1	6
NONE	OG0004097	1	0	3	0	2	0	6
NONE	OG0004098	1	1	1	1	1	1	6
NONE	OG0004099	1	0	2	1	0	2	6
NONE	OG0004100	1	1	1	1	1	1	6
NONE	OG0004101	4	0	1	0	0	1	6
NONE	OG0004102	1	0	1	2	1	1	6
NONE	OG0004103	1	0	1	2	1	1	6
NONE	OG0004104	3	0	0	0	0	3	6
NONE	OG0004105	1	1	1	1	1	1	6
NONE	OG0004106	1	1	1	1	1	1	6
NONE	OG0004107	1	1	1	1	1	1	6
NONE	OG0004108	1	1	1	2	0	1	6
NONE	OG0004109	1	1	1	1	1	1	6
NONE	OG0004110	1	1	1	1	1	1	6
NONE	OG0004111	1	1	1	1	1	1	6
NONE	OG0004112	1	1	1	1	1	1	6
NONE	OG0004113	1	1	1	1	1	1	6
NONE	OG0004114	1	1	1	1	1	1	6
NONE	OG0004115	1	1	1	1	1	1	6
NONE	OG0004116	1	1	1	1	1	1	6
NONE	OG0004117	1	1	1	1	1	1	6
NONE	OG0004118	2	0	4	0	0	0	6
NONE	OG0004119	1	1	1	1	1	1	6
NONE	OG0004120	1	1	1	1	1	1	6
NONE	OG0004121	1	1	1	1	1	1	6
NONE	OG0004122	1	1	1	1	1	1	6
NONE	OG0004123	5	0	0	0	0	1	6
NONE	OG0004124	1	1	1	1	1	1	6
NONE	OG0004125	1	1	1	1	1	1	6
NONE	OG0004126	1	1	1	1	1	1	6
NONE	OG0004127	1	1	1	1	1	1	6
NONE	OG0004128	1	1	1	1	1	1	6
NONE	OG0004129	1	1	1	1	1	1	6
NONE	OG0004130	1	1	1	1	1	1	6
NONE	OG0004131	1	1	1	1	1	1	6
NONE	OG0004132	1	1	1	1	1	1	6
NONE	OG0004133	1	1	1	1	1	1	6
NONE	OG0004134	1	1	1	1	1	1	6
NONE	OG0004135	1	1	1	1	1	1	6
NONE	OG0004136	1	1	1	1	1	1	6
NONE	OG0004137	2	0	2	0	0	2	6
NONE	OG0004138	1	1	1	1	1	1	6
NONE	OG0004139	1	1	1	1	1	1	6
NONE	OG0004140	1	1	1	1	1	1	6
NONE	OG0004141	1	1	1	1	1	1	6
NONE	OG0004142	1	1	1	1	1	1	6
NONE	OG0004143	1	1	1	1	1	1	6
NONE	OG0004144	1	1	1	1	1	1	6
NONE	OG0004145	1	1	1	1	1	1	6
NONE	OG0004146	1	1	1	1	1	1	6
NONE	OG0004147	1	1	1	1	1	1	6
NONE	OG0004148	2	1	1	1	0	1	6
NONE	OG0004149	1	1	1	1	1	1	6
NONE	OG0004150	1	1	1	1	1	1	6
NONE	OG0004151	1	1	1	1	1	1	6
NONE	OG0004152	1	1	1	1	1	1	6
NONE	OG0004153	1	1	1	1	1	1	6
NONE	OG0004154	2	0	1	1	1	1	6
NONE	OG0004155	1	1	1	1	1	1	6
NONE	OG0004156	1	1	1	1	1	1	6
NONE	OG0004157	1	1	1	1	1	1	6
NONE	OG0004158	1	1	1	1	1	1	6
NONE	OG0004159	1	1	1	1	1	1	6
NONE	OG0004160	1	1	1	1	1	1	6
NONE	OG0004161	1	1	1	1	1	1	6
NONE	OG0004162	1	1	1	1	1	1	6
NONE	OG0004163	1	1	1	1	1	1	6
NONE	OG0004164	1	1	1	1	1	1	6
NONE	OG0004165	1	1	1	1	1	1	6
NONE	OG0004166	1	1	1	1	1	1	6
NONE	OG0004167	1	1	1	1	1	1	6
NONE	OG0004168	1	1	1	1	1	1	6
NONE	OG0004169	1	1	1	1	1	1	6
NONE	OG0004170	1	1	1	1	1	1	6
NONE	OG0004171	1	1	1	1	1	1	6
NONE	OG0004172	1	1	1	1	1	1	6
NONE	OG0004173	1	1	1	1	1	1	6
NONE	OG0004174	1	1	1	1	1	1	6
NONE	OG0004175	1	1	1	1	1	1	6
NONE	OG0004176	1	1	1	1	1	1	6
NONE	OG0004177	1	1	1	1	1	1	6
NONE	OG0004178	1	1	1	1	1	1	6
NONE	OG0004179	1	1	1	1	1	1	6
NONE	OG0004180	1	1	1	1	1	1	6
NONE	OG0004181	1	1	1	1	1	1	6
NONE	OG0004182	1	1	1	1	1	1	6
NONE	OG0004183	1	1	1	1	1	1	6
NONE	OG0004184	1	1	1	2	0	1	6
NONE	OG0004185	1	1	1	1	1	1	6
NONE	OG0004186	2	0	1	1	1	1	6
NONE	OG0004187	2	1	1	0	1	1	6
NONE	OG0004188	2	0	1	2	0	1	6
NONE	OG0004189	2	0	1	2	0	1	6
NONE	OG0004190	2	0	1	3	0	0	6
NONE	OG0004191	2	0	1	0	0	3	6
NONE	OG0004192	1	1	1	1	1	1	6
NONE	OG0004193	1	1	1	1	1	1	6
NONE	OG0004194	1	1	1	1	1	1	6
NONE	OG0004195	1	1	1	1	1	1	6
NONE	OG0004196	1	1	1	1	1	1	6
NONE	OG0004197	1	1	1	1	1	1	6
NONE	OG0004198	2	0	1	1	1	1	6
NONE	OG0004199	2	0	1	1	1	1	6
NONE	OG0004200	2	1	1	1	0	1	6
NONE	OG0004201	2	0	1	1	1	1	6
NONE	OG0004202	1	1	1	1	1	1	6
NONE	OG0004203	1	1	1	1	1	1	6
NONE	OG0004204	4	0	1	0	0	1	6
NONE	OG0004205	1	1	1	1	1	1	6
NONE	OG0004206	1	1	1	1	1	1	6
NONE	OG0004207	1	1	1	1	1	1	6
NONE	OG0004208	2	0	1	1	1	1	6
NONE	OG0004209	1	1	1	1	1	1	6
NONE	OG0004210	1	1	1	1	1	1	6
NONE	OG0004211	1	1	1	1	1	1	6
NONE	OG0004212	1	1	1	1	1	1	6
NONE	OG0004213	1	1	1	1	1	1	6
NONE	OG0004214	1	1	1	1	1	1	6
NONE	OG0004215	1	1	1	1	1	1	6
NONE	OG0004216	1	1	1	1	1	1	6
NONE	OG0004217	1	1	1	1	1	1	6
NONE	OG0004218	1	1	1	1	1	1	6
NONE	OG0004219	1	1	1	1	1	1	6
NONE	OG0004220	1	1	1	1	1	1	6
NONE	OG0004221	5	0	0	0	0	1	6
NONE	OG0004222	1	1	1	1	1	1	6
NONE	OG0004223	1	1	1	1	1	1	6
NONE	OG0004224	1	0	1	1	2	1	6
NONE	OG0004225	1	1	1	1	1	1	6
NONE	OG0004226	1	1	1	1	1	1	6
NONE	OG0004227	1	1	1	1	1	1	6
NONE	OG0004228	1	1	2	1	0	1	6
NONE	OG0004229	1	1	1	1	1	1	6
NONE	OG0004230	1	0	1	2	1	1	6
NONE	OG0004231	1	1	1	1	1	1	6
NONE	OG0004232	1	1	1	1	1	1	6
NONE	OG0004233	1	1	1	1	1	1	6
NONE	OG0004234	1	1	1	1	1	1	6
NONE	OG0004235	1	1	1	1	1	1	6
NONE	OG0004236	6	0	0	0	0	0	6
NONE	OG0004237	2	0	1	1	1	1	6
NONE	OG0004238	1	1	1	1	1	1	6
NONE	OG0004239	1	1	1	1	1	1	6
NONE	OG0004240	1	1	1	1	1	1	6
NONE	OG0004241	1	1	1	1	1	1	6
NONE	OG0004242	1	1	1	1	1	1	6
NONE	OG0004243	1	1	1	1	1	1	6
NONE	OG0004244	1	1	1	1	1	1	6
NONE	OG0004245	2	1	1	1	0	1	6
NONE	OG0004246	1	1	1	1	1	1	6
NONE	OG0004247	1	1	1	1	1	1	6
NONE	OG0004248	1	1	1	1	1	1	6
NONE	OG0004249	1	1	1	1	1	1	6
NONE	OG0004250	1	1	1	1	1	1	6
NONE	OG0004251	1	1	1	1	1	1	6
NONE	OG0004252	1	1	1	1	1	1	6
NONE	OG0004253	1	1	1	1	1	1	6
NONE	OG0004254	1	1	1	1	1	1	6
NONE	OG0004255	1	1	1	1	1	1	6
NONE	OG0004256	1	1	1	1	1	1	6
NONE	OG0004257	1	1	1	1	1	1	6
NONE	OG0004258	1	1	1	1	1	1	6
NONE	OG0004259	1	1	1	1	1	1	6
NONE	OG0004260	1	1	1	1	1	1	6
NONE	OG0004261	1	1	1	1	1	1	6
NONE	OG0004262	1	1	1	1	1	1	6
NONE	OG0004263	1	1	1	1	1	1	6
NONE	OG0004264	1	1	1	1	1	1	6
NONE	OG0004265	1	1	1	1	1	1	6
NONE	OG0004266	1	1	1	1	1	1	6
NONE	OG0004267	1	1	1	1	1	1	6
NONE	OG0004268	1	1	1	1	1	1	6
NONE	OG0004269	1	0	1	2	1	1	6
NONE	OG0004270	1	1	1	1	1	1	6
NONE	OG0004271	1	1	1	1	1	1	6
NONE	OG0004272	1	1	1	1	1	1	6
NONE	OG0004273	1	1	1	1	1	1	6
NONE	OG0004274	1	1	1	1	1	1	6
NONE	OG0004275	1	1	1	1	1	1	6
NONE	OG0004276	1	1	1	1	1	1	6
NONE	OG0004277	1	1	1	1	1	1	6
NONE	OG0004278	1	1	1	1	1	1	6
NONE	OG0004279	1	1	1	1	1	1	6
NONE	OG0004280	1	1	1	1	1	1	6
NONE	OG0004281	2	1	1	0	1	1	6
NONE	OG0004282	2	1	1	0	1	1	6
NONE	OG0004283	1	1	1	1	1	1	6
NONE	OG0004284	1	1	1	1	1	1	6
NONE	OG0004285	1	1	1	1	1	1	6
NONE	OG0004286	1	1	1	1	1	1	6
NONE	OG0004287	1	1	1	1	1	1	6
NONE	OG0004288	1	1	1	1	1	1	6
NONE	OG0004289	1	1	1	1	1	1	6
NONE	OG0004290	1	1	1	1	1	1	6
NONE	OG0004291	1	1	1	2	0	1	6
NONE	OG0004292	1	1	1	1	1	1	6
NONE	OG0004293	1	1	1	1	1	1	6
NONE	OG0004294	1	1	1	1	1	1	6
NONE	OG0004295	1	1	1	1	1	1	6
NONE	OG0004296	1	1	1	1	1	1	6
NONE	OG0004297	1	1	1	1	1	1	6
NONE	OG0004298	1	1	1	1	1	1	6
NONE	OG0004299	1	1	1	1	1	1	6
NONE	OG0004300	1	1	1	1	1	1	6
NONE	OG0004301	1	0	0	0	5	0	6
NONE	OG0004302	1	1	1	1	1	1	6
NONE	OG0004303	1	1	1	1	1	1	6
NONE	OG0004304	1	1	1	1	1	1	6
NONE	OG0004305	1	1	1	1	1	1	6
NONE	OG0004306	1	1	1	1	1	1	6
NONE	OG0004307	1	1	1	1	1	1	6
NONE	OG0004308	1	1	1	1	1	1	6
NONE	OG0004309	1	1	1	1	1	1	6
NONE	OG0004310	1	1	1	1	1	1	6
NONE	OG0004311	1	1	1	1	1	1	6
NONE	OG0004312	1	1	1	1	1	1	6
NONE	OG0004313	1	1	1	1	1	1	6
NONE	OG0004314	1	1	1	1	1	1	6
NONE	OG0004315	1	1	1	1	1	1	6
NONE	OG0004316	1	1	1	1	1	1	6
NONE	OG0004317	1	1	1	1	1	1	6
NONE	OG0004318	1	1	1	1	1	1	6
NONE	OG0004319	1	1	1	1	1	1	6
NONE	OG0004320	1	1	1	1	1	1	6
NONE	OG0004321	1	1	1	1	1	1	6
NONE	OG0004322	1	1	1	1	1	1	6
NONE	OG0004323	1	1	1	1	1	1	6
NONE	OG0004324	1	1	1	1	1	1	6
NONE	OG0004325	1	1	1	1	1	1	6
NONE	OG0004326	1	1	1	1	1	1	6
NONE	OG0004327	1	1	1	1	1	1	6
NONE	OG0004328	1	1	1	1	1	1	6
NONE	OG0004329	1	1	1	1	1	1	6
NONE	OG0004330	1	1	1	1	1	1	6
NONE	OG0004331	1	1	1	1	1	1	6
NONE	OG0004332	1	1	1	1	1	1	6
NONE	OG0004333	1	1	1	1	1	1	6
NONE	OG0004334	1	1	1	1	1	1	6
NONE	OG0004335	6	0	0	0	0	0	6
NONE	OG0004336	1	1	1	1	1	1	6
NONE	OG0004337	1	1	1	1	1	1	6
NONE	OG0004338	1	0	1	1	2	1	6
NONE	OG0004339	6	0	0	0	0	0	6
NONE	OG0004340	1	1	1	1	1	1	6
NONE	OG0004341	1	1	1	1	1	1	6
NONE	OG0004342	1	1	1	1	1	1	6
NONE	OG0004343	1	1	1	1	1	1	6
NONE	OG0004344	1	1	1	1	1	1	6
NONE	OG0004345	1	1	1	1	1	1	6
NONE	OG0004346	1	1	1	1	1	1	6
NONE	OG0004347	1	1	1	1	1	1	6
NONE	OG0004348	1	1	1	1	1	1	6
NONE	OG0004349	1	1	1	1	1	1	6
NONE	OG0004350	1	1	1	1	1	1	6
NONE	OG0004351	1	1	1	1	1	1	6
NONE	OG0004352	1	1	1	1	1	1	6
NONE	OG0004353	1	1	1	1	1	1	6
NONE	OG0004354	1	1	1	1	1	1	6
NONE	OG0004355	1	1	1	1	1	1	6
NONE	OG0004356	1	1	1	1	1	1	6
NONE	OG0004357	1	1	1	1	1	1	6
NONE	OG0004358	1	1	1	1	1	1	6
NONE	OG0004359	1	1	1	1	1	1	6
NONE	OG0004360	1	1	1	1	1	1	6
NONE	OG0004361	1	1	1	1	1	1	6
NONE	OG0004362	1	1	1	1	1	1	6
NONE	OG0004363	1	1	1	1	1	1	6
NONE	OG0004364	1	1	1	1	1	1	6
NONE	OG0004365	1	1	1	1	1	1	6
NONE	OG0004366	1	1	1	1	1	1	6
NONE	OG0004367	1	1	1	1	1	1	6
NONE	OG0004368	1	1	1	1	1	1	6
NONE	OG0004369	1	1	1	1	1	1	6
NONE	OG0004370	1	1	1	1	1	1	6
NONE	OG0004371	1	1	1	2	0	1	6
NONE	OG0004372	1	1	1	2	0	1	6
NONE	OG0004373	1	1	1	1	1	1	6
NONE	OG0004374	1	1	1	1	1	1	6
NONE	OG0004375	1	1	1	1	1	1	6
NONE	OG0004376	1	1	1	1	1	1	6
NONE	OG0004377	1	1	1	1	1	1	6
NONE	OG0004378	1	1	1	1	1	1	6
NONE	OG0004379	1	1	1	1	1	1	6
NONE	OG0004380	1	1	1	1	1	1	6
NONE	OG0004381	1	1	1	1	1	1	6
NONE	OG0004382	1	1	1	1	1	1	6
NONE	OG0004383	1	1	1	1	1	1	6
NONE	OG0004384	4	0	2	0	0	0	6
NONE	OG0004385	1	1	1	1	1	1	6
NONE	OG0004386	1	1	1	1	1	1	6
NONE	OG0004387	1	1	1	1	1	1	6
NONE	OG0004388	1	1	1	1	1	1	6
NONE	OG0004389	1	1	1	1	1	1	6
NONE	OG0004390	2	2	0	0	1	1	6
NONE	OG0004391	2	1	1	0	1	1	6
NONE	OG0004392	2	0	4	0	0	0	6
NONE	OG0004393	1	1	1	0	1	2	6
NONE	OG0004394	1	1	1	1	0	2	6
NONE	OG0004395	2	0	1	0	0	3	6
NONE	OG0004396	1	1	1	1	1	1	6
NONE	OG0004397	1	1	3	0	1	0	6
NONE	OG0004398	1	1	2	0	1	1	6
NONE	OG0004399	1	1	1	1	1	1	6
NONE	OG0004400	1	1	1	1	1	1	6
NONE	OG0004401	1	1	1	1	1	1	6
NONE	OG0004402	1	1	1	1	1	1	6
NONE	OG0004403	1	1	1	1	1	1	6
NONE	OG0004404	1	1	1	1	1	1	6
NONE	OG0004405	1	1	1	1	1	1	6
NONE	OG0004406	1	1	1	1	1	1	6
NONE	OG0004407	1	1	1	1	1	1	6
NONE	OG0004408	1	1	1	1	1	1	6
NONE	OG0004409	1	1	1	1	1	1	6
NONE	OG0004410	1	1	1	1	1	1	6
NONE	OG0004411	1	1	1	1	1	1	6
NONE	OG0004412	1	1	1	1	1	1	6
NONE	OG0004413	1	1	1	1	1	1	6
NONE	OG0004414	1	1	1	1	1	1	6
NONE	OG0004415	2	0	4	0	0	0	6
NONE	OG0004416	1	1	1	1	1	1	6
NONE	OG0004417	1	0	3	0	0	2	6
NONE	OG0004418	1	1	1	1	1	1	6
NONE	OG0004419	1	1	1	0	1	2	6
NONE	OG0004420	1	1	1	1	1	1	6
NONE	OG0004421	1	1	1	1	1	1	6
NONE	OG0004422	1	1	1	1	1	1	6
NONE	OG0004423	1	1	1	1	1	1	6
NONE	OG0004424	1	1	1	1	1	1	6
NONE	OG0004425	1	1	1	1	1	1	6
NONE	OG0004426	1	1	1	1	1	1	6
NONE	OG0004427	1	1	1	1	1	1	6
NONE	OG0004428	1	1	1	1	1	1	6
NONE	OG0004429	1	1	1	1	1	1	6
NONE	OG0004430	1	1	1	1	1	1	6
NONE	OG0004431	1	1	1	1	1	1	6
NONE	OG0004432	6	0	0	0	0	0	6
NONE	OG0004433	1	1	1	1	1	1	6
NONE	OG0004434	1	1	1	1	1	1	6
NONE	OG0004435	1	1	1	1	1	1	6
NONE	OG0004436	1	1	1	1	1	1	6
NONE	OG0004437	1	1	1	1	1	1	6
NONE	OG0004438	1	1	1	1	1	1	6
NONE	OG0004439	1	1	1	0	2	1	6
NONE	OG0004440	1	1	1	1	1	1	6
NONE	OG0004441	1	1	1	1	1	1	6
NONE	OG0004442	1	1	1	1	1	1	6
NONE	OG0004443	1	1	1	1	1	1	6
NONE	OG0004444	1	1	1	1	1	1	6
NONE	OG0004445	1	1	1	1	1	1	6
NONE	OG0004446	1	1	1	1	1	1	6
NONE	OG0004447	4	0	1	0	0	1	6
NONE	OG0004448	1	0	1	2	1	1	6
NONE	OG0004449	1	1	1	2	1	0	6
NONE	OG0004450	1	1	1	1	1	1	6
NONE	OG0004451	1	1	1	1	1	1	6
NONE	OG0004452	1	1	1	1	1	1	6
NONE	OG0004453	1	1	1	1	1	1	6
NONE	OG0004454	3	0	3	0	0	0	6
NONE	OG0004455	1	1	1	1	1	1	6
NONE	OG0004456	1	1	1	1	1	1	6
NONE	OG0004457	1	1	1	1	1	1	6
NONE	OG0004458	6	0	0	0	0	0	6
NONE	OG0004459	1	1	1	1	1	1	6
NONE	OG0004460	1	1	1	1	1	1	6
NONE	OG0004461	1	1	1	1	1	1	6
NONE	OG0004462	1	0	1	1	1	2	6
NONE	OG0004463	1	1	1	1	1	1	6
NONE	OG0004464	2	0	1	1	1	1	6
NONE	OG0004465	1	1	1	1	1	1	6
NONE	OG0004466	1	1	1	1	1	1	6
NONE	OG0004467	1	1	1	2	0	1	6
NONE	OG0004468	1	1	1	1	1	1	6
NONE	OG0004469	1	1	1	1	1	1	6
NONE	OG0004470	1	1	1	1	1	1	6
NONE	OG0004471	1	1	1	1	1	1	6
NONE	OG0004472	1	1	1	1	1	1	6
NONE	OG0004473	1	1	1	1	1	1	6
NONE	OG0004474	1	1	1	1	1	1	6
NONE	OG0004475	1	1	1	1	1	1	6
NONE	OG0004476	1	1	1	1	1	1	6
NONE	OG0004477	1	1	1	1	1	1	6
NONE	OG0004478	1	1	1	1	1	1	6
NONE	OG0004479	1	1	1	1	1	1	6
NONE	OG0004480	1	1	1	1	1	1	6
NONE	OG0004481	1	1	1	1	1	1	6
NONE	OG0004482	1	1	1	1	1	1	6
NONE	OG0004483	1	1	1	1	1	1	6
NONE	OG0004484	1	1	1	1	1	1	6
NONE	OG0004485	1	1	1	1	1	1	6
NONE	OG0004486	1	1	1	1	1	1	6
NONE	OG0004487	1	1	1	2	0	1	6
NONE	OG0004488	1	1	1	1	1	1	6
NONE	OG0004489	6	0	0	0	0	0	6
NONE	OG0004490	1	1	1	1	1	1	6
NONE	OG0004491	1	1	1	1	1	1	6
NONE	OG0004492	1	1	1	1	1	1	6
NONE	OG0004493	1	1	1	1	1	1	6
NONE	OG0004494	1	1	1	1	1	1	6
NONE	OG0004495	1	1	1	1	1	1	6
NONE	OG0004496	1	1	1	1	1	1	6
NONE	OG0004497	1	1	1	1	1	1	6
NONE	OG0004498	1	1	1	1	1	1	6
NONE	OG0004499	1	1	1	1	1	1	6
NONE	OG0004500	1	1	1	1	1	1	6
NONE	OG0004501	1	1	1	1	1	1	6
NONE	OG0004502	1	1	1	1	1	1	6
NONE	OG0004503	1	1	1	1	1	1	6
NONE	OG0004504	1	1	1	1	1	1	6
NONE	OG0004505	1	1	1	1	1	1	6
NONE	OG0004506	1	1	1	1	1	1	6
NONE	OG0004507	1	1	1	1	1	1	6
NONE	OG0004508	1	1	1	1	1	1	6
NONE	OG0004509	1	1	1	1	1	1	6
NONE	OG0004510	1	1	1	1	1	1	6
NONE	OG0004511	1	1	1	1	1	1	6
NONE	OG0004512	1	1	1	1	1	1	6
NONE	OG0004513	1	1	1	1	1	1	6
NONE	OG0004514	1	1	1	1	1	1	6
NONE	OG0004515	1	1	1	1	1	1	6
NONE	OG0004516	1	1	1	1	1	1	6
NONE	OG0004517	1	1	1	1	1	1	6
NONE	OG0004518	1	1	1	1	1	1	6
NONE	OG0004519	1	1	1	1	1	1	6
NONE	OG0004520	1	1	1	1	1	1	6
NONE	OG0004521	1	1	1	1	1	1	6
NONE	OG0004522	1	1	1	1	1	1	6
NONE	OG0004523	1	1	1	1	1	1	6
NONE	OG0004524	1	1	1	1	1	1	6
NONE	OG0004525	1	1	1	1	1	1	6
NONE	OG0004526	1	1	1	1	1	1	6
NONE	OG0004527	1	1	1	1	1	1	6
NONE	OG0004528	1	1	1	1	1	1	6
NONE	OG0004529	1	1	1	1	1	1	6
NONE	OG0004530	1	1	1	1	1	1	6
NONE	OG0004531	1	1	1	1	1	1	6
NONE	OG0004532	1	1	1	1	1	1	6
NONE	OG0004533	1	1	1	1	1	1	6
NONE	OG0004534	1	1	1	1	1	1	6
NONE	OG0004535	1	1	1	1	1	1	6
NONE	OG0004536	1	1	1	1	1	1	6
NONE	OG0004537	1	1	1	1	1	1	6
NONE	OG0004538	1	1	1	1	1	1	6
NONE	OG0004539	1	1	1	1	1	1	6
NONE	OG0004540	1	1	1	1	1	1	6
NONE	OG0004541	1	1	1	1	1	1	6
NONE	OG0004542	1	1	1	1	1	1	6
NONE	OG0004543	1	1	1	1	1	1	6
NONE	OG0004544	1	1	1	1	1	1	6
NONE	OG0004545	1	1	1	1	1	1	6
NONE	OG0004546	1	1	1	1	1	1	6
NONE	OG0004547	1	1	1	1	1	1	6
NONE	OG0004548	1	1	1	1	1	1	6
NONE	OG0004549	1	0	1	3	0	1	6
NONE	OG0004550	1	1	1	1	1	1	6
NONE	OG0004551	1	1	1	1	1	1	6
NONE	OG0004552	1	1	1	1	1	1	6
NONE	OG0004553	1	1	1	1	1	1	6
NONE	OG0004554	1	1	1	1	1	1	6
NONE	OG0004555	1	1	1	1	1	1	6
NONE	OG0004556	1	1	1	1	1	1	6
NONE	OG0004557	1	1	1	1	1	1	6
NONE	OG0004558	1	1	1	1	1	1	6
NONE	OG0004559	1	1	1	1	1	1	6
NONE	OG0004560	1	1	1	1	1	1	6
NONE	OG0004561	1	1	1	1	1	1	6
NONE	OG0004562	1	1	1	1	1	1	6
NONE	OG0004563	1	1	1	1	1	1	6
NONE	OG0004564	1	1	1	1	1	1	6
NONE	OG0004565	1	1	1	1	1	1	6
NONE	OG0004566	1	1	1	1	1	1	6
NONE	OG0004567	1	1	1	1	1	1	6
NONE	OG0004568	1	1	1	1	1	1	6
NONE	OG0004569	1	1	1	1	1	1	6
NONE	OG0004570	1	1	1	1	1	1	6
NONE	OG0004571	1	1	1	1	1	1	6
NONE	OG0004572	1	1	1	1	1	1	6
NONE	OG0004573	4	0	2	0	0	0	6
NONE	OG0004574	1	0	2	2	0	1	6
NONE	OG0004575	1	1	1	1	1	1	6
NONE	OG0004576	6	0	0	0	0	0	6
NONE	OG0004577	1	1	1	1	1	1	6
NONE	OG0004578	1	1	1	1	1	1	6
NONE	OG0004579	1	1	1	1	1	1	6
NONE	OG0004580	1	1	1	1	1	1	6
NONE	OG0004581	1	1	1	1	1	1	6
NONE	OG0004582	1	1	1	1	1	1	6
NONE	OG0004583	5	0	1	0	0	0	6
NONE	OG0004584	1	1	1	1	1	1	6
NONE	OG0004585	1	1	1	1	1	1	6
NONE	OG0004586	1	1	1	1	1	1	6
NONE	OG0004587	1	1	1	1	1	1	6
NONE	OG0004588	1	1	1	1	1	1	6
NONE	OG0004589	1	1	1	1	1	1	6
NONE	OG0004590	1	1	1	2	0	1	6
NONE	OG0004591	1	1	1	1	1	1	6
NONE	OG0004592	1	1	1	1	1	1	6
NONE	OG0004593	1	1	1	1	1	1	6
NONE	OG0004594	1	1	1	1	1	1	6
NONE	OG0004595	1	0	1	1	1	2	6
NONE	OG0004596	1	1	1	1	1	1	6
NONE	OG0004597	1	1	1	1	1	1	6
NONE	OG0004598	1	1	1	1	1	1	6
NONE	OG0004599	1	1	1	1	1	1	6
NONE	OG0004600	1	1	1	1	1	1	6
NONE	OG0004601	1	1	1	1	1	1	6
NONE	OG0004602	1	1	1	1	1	1	6
NONE	OG0004603	1	1	1	1	1	1	6
NONE	OG0004604	2	1	1	1	1	0	6
NONE	OG0004605	1	1	1	1	1	1	6
NONE	OG0004606	1	1	1	1	1	1	6
NONE	OG0004607	1	1	1	1	1	1	6
NONE	OG0004608	1	1	1	1	1	1	6
NONE	OG0004609	1	1	1	1	1	1	6
NONE	OG0004610	1	1	1	1	1	1	6
NONE	OG0004611	1	1	1	1	1	1	6
NONE	OG0004612	1	1	1	1	1	1	6
NONE	OG0004613	1	1	1	1	1	1	6
NONE	OG0004614	1	1	1	1	1	1	6
NONE	OG0004615	1	1	1	1	1	1	6
NONE	OG0004616	1	1	1	1	1	1	6
NONE	OG0004617	1	1	1	1	1	1	6
NONE	OG0004618	1	1	1	1	1	1	6
NONE	OG0004619	1	1	1	1	1	1	6
NONE	OG0004620	1	1	1	1	1	1	6
NONE	OG0004621	1	1	1	1	1	1	6
NONE	OG0004622	1	1	1	1	1	1	6
NONE	OG0004623	1	1	1	1	1	1	6
NONE	OG0004624	1	1	1	1	1	1	6
NONE	OG0004625	1	1	1	1	1	1	6
NONE	OG0004626	1	1	1	1	1	1	6
NONE	OG0004627	1	1	1	1	1	1	6
NONE	OG0004628	1	0	1	1	2	1	6
NONE	OG0004629	2	0	1	1	1	1	6
NONE	OG0004630	1	1	1	1	1	1	6
NONE	OG0004631	1	1	1	1	1	1	6
NONE	OG0004632	1	1	1	1	1	1	6
NONE	OG0004633	1	1	1	1	1	1	6
NONE	OG0004634	1	1	1	1	1	1	6
NONE	OG0004635	1	1	1	1	1	1	6
NONE	OG0004636	6	0	0	0	0	0	6
NONE	OG0004637	2	1	1	2	0	0	6
NONE	OG0004638	1	1	1	1	1	1	6
NONE	OG0004639	1	1	1	1	1	1	6
NONE	OG0004640	1	1	1	1	1	1	6
NONE	OG0004641	1	1	1	1	1	1	6
NONE	OG0004642	1	1	1	1	1	1	6
NONE	OG0004643	1	1	1	1	1	1	6
NONE	OG0004644	2	0	1	1	1	1	6
NONE	OG0004645	1	1	1	1	1	1	6
NONE	OG0004646	1	0	2	1	1	1	6
NONE	OG0004647	1	1	1	1	1	1	6
NONE	OG0004648	1	1	1	1	1	1	6
NONE	OG0004649	1	1	1	1	1	1	6
NONE	OG0004650	1	1	1	1	1	1	6
NONE	OG0004651	1	0	2	1	1	1	6
NONE	OG0004652	2	0	0	4	0	0	6
NONE	OG0004653	2	0	2	1	0	1	6
NONE	OG0004654	1	1	1	1	1	1	6
NONE	OG0004655	1	1	1	1	1	1	6
NONE	OG0004656	1	1	1	1	1	1	6
NONE	OG0004657	1	1	1	1	1	1	6
NONE	OG0004658	1	1	1	1	1	1	6
NONE	OG0004659	1	1	1	1	1	1	6
NONE	OG0004660	1	1	1	1	1	1	6
NONE	OG0004661	1	1	1	1	1	1	6
NONE	OG0004662	2	1	1	1	0	1	6
NONE	OG0004663	2	1	1	1	0	1	6
NONE	OG0004664	1	1	1	1	1	1	6
NONE	OG0004665	1	1	1	1	1	1	6
NONE	OG0004666	1	1	1	1	1	1	6
NONE	OG0004667	1	1	1	1	1	1	6
NONE	OG0004668	1	1	1	1	1	1	6
NONE	OG0004669	1	1	1	1	1	1	6
NONE	OG0004670	1	1	1	1	1	1	6
NONE	OG0004671	1	1	1	1	1	1	6
NONE	OG0004672	1	1	1	1	1	1	6
NONE	OG0004673	1	2	1	1	0	1	6
NONE	OG0004674	1	0	2	3	0	0	6
NONE	OG0004675	1	1	1	2	0	1	6
NONE	OG0004676	1	0	1	2	1	1	6
NONE	OG0004677	1	1	1	1	1	1	6
NONE	OG0004678	1	1	1	1	1	1	6
NONE	OG0004679	1	1	1	1	1	1	6
NONE	OG0004680	1	1	1	2	0	1	6
NONE	OG0004681	1	1	1	2	0	1	6
NONE	OG0004682	1	1	1	1	1	1	6
NONE	OG0004683	1	1	1	1	1	1	6
NONE	OG0004684	1	1	1	1	1	1	6
NONE	OG0004685	1	1	1	1	1	1	6
NONE	OG0004686	1	1	1	1	1	1	6
NONE	OG0004687	1	1	1	2	0	1	6
NONE	OG0004688	1	1	1	1	1	1	6
NONE	OG0004689	1	1	1	2	0	1	6
NONE	OG0004690	1	1	1	1	1	1	6
NONE	OG0004691	1	1	1	1	1	1	6
NONE	OG0004692	1	1	1	1	1	1	6
NONE	OG0004693	1	1	1	1	1	1	6
NONE	OG0004694	1	1	1	1	1	1	6
NONE	OG0004695	1	1	1	1	1	1	6
NONE	OG0004696	1	1	1	1	1	1	6
NONE	OG0004697	1	1	1	1	1	1	6
NONE	OG0004698	1	1	1	1	1	1	6
NONE	OG0004699	1	1	1	1	1	1	6
NONE	OG0004700	1	1	1	1	1	1	6
NONE	OG0004701	1	1	1	1	1	1	6
NONE	OG0004702	1	1	1	1	1	1	6
NONE	OG0004703	1	1	1	1	1	1	6
NONE	OG0004704	1	1	1	1	1	1	6
NONE	OG0004705	1	1	1	1	1	1	6
NONE	OG0004706	1	1	1	1	1	1	6
NONE	OG0004707	1	1	1	1	1	1	6
NONE	OG0004708	2	0	1	1	1	1	6
NONE	OG0004709	1	1	1	1	1	1	6
NONE	OG0004710	2	1	1	1	0	1	6
NONE	OG0004711	2	1	1	0	1	1	6
NONE	OG0004712	1	1	1	1	1	1	6
NONE	OG0004713	1	1	1	1	1	1	6
NONE	OG0004714	1	1	1	1	1	1	6
NONE	OG0004715	1	1	1	1	1	1	6
NONE	OG0004716	1	0	1	2	1	1	6
NONE	OG0004717	1	1	1	1	1	1	6
NONE	OG0004718	1	1	1	1	1	1	6
NONE	OG0004719	1	1	1	1	1	1	6
NONE	OG0004720	1	1	1	1	1	1	6
NONE	OG0004721	1	1	1	1	1	1	6
NONE	OG0004722	1	0	2	2	0	1	6
NONE	OG0004723	1	1	1	1	1	1	6
NONE	OG0004724	1	1	1	1	1	1	6
NONE	OG0004725	1	1	1	1	1	1	6
NONE	OG0004726	1	1	1	1	1	1	6
NONE	OG0004727	1	1	1	1	1	1	6
NONE	OG0004728	1	1	1	1	1	1	6
NONE	OG0004729	1	1	1	1	1	1	6
NONE	OG0004730	1	1	1	1	1	1	6
NONE	OG0004731	1	1	1	1	1	1	6
NONE	OG0004732	1	0	2	1	1	1	6
NONE	OG0004733	1	1	1	1	1	1	6
NONE	OG0004734	1	1	1	1	1	1	6
NONE	OG0004735	1	1	1	1	1	1	6
NONE	OG0004736	1	1	1	1	1	1	6
NONE	OG0004737	1	1	1	1	1	1	6
NONE	OG0004738	1	1	1	1	1	1	6
NONE	OG0004739	1	1	1	1	1	1	6
NONE	OG0004740	1	1	1	1	1	1	6
NONE	OG0004741	1	1	1	1	1	1	6
NONE	OG0004742	1	1	1	1	1	1	6
NONE	OG0004743	1	1	1	1	1	1	6
NONE	OG0004744	1	1	1	1	1	1	6
NONE	OG0004745	1	1	1	1	1	1	6
NONE	OG0004746	1	1	1	1	1	1	6
NONE	OG0004747	1	1	1	1	1	1	6
NONE	OG0004748	2	0	3	0	0	1	6
NONE	OG0004749	1	1	1	1	1	1	6
NONE	OG0004750	1	1	1	1	1	1	6
NONE	OG0004751	1	1	1	1	1	1	6
NONE	OG0004752	1	1	1	1	1	1	6
NONE	OG0004753	1	1	1	1	1	1	6
NONE	OG0004754	1	1	1	1	1	1	6
NONE	OG0004755	1	1	1	1	1	1	6
NONE	OG0004756	1	1	1	1	1	1	6
NONE	OG0004757	1	1	1	1	1	1	6
NONE	OG0004758	1	1	1	1	1	1	6
NONE	OG0004759	1	1	1	1	1	1	6
NONE	OG0004760	1	1	1	1	1	1	6
NONE	OG0004761	1	1	1	1	1	1	6
NONE	OG0004762	1	1	1	1	1	1	6
NONE	OG0004763	1	1	1	1	1	1	6
NONE	OG0004764	1	1	1	1	1	1	6
NONE	OG0004765	1	1	1	1	1	1	6
NONE	OG0004766	1	1	1	1	1	1	6
NONE	OG0004767	2	0	1	1	1	1	6
NONE	OG0004768	1	1	1	1	1	1	6
NONE	OG0004769	1	1	1	1	1	1	6
NONE	OG0004770	1	1	1	1	1	1	6
NONE	OG0004771	1	1	1	1	1	1	6
NONE	OG0004772	1	1	1	1	1	1	6
NONE	OG0004773	1	1	1	1	1	1	6
NONE	OG0004774	1	1	1	1	1	1	6
NONE	OG0004775	1	1	1	1	1	1	6
NONE	OG0004776	1	1	1	1	1	1	6
NONE	OG0004777	1	1	2	1	0	1	6
NONE	OG0004778	1	1	1	1	1	1	6
NONE	OG0004779	1	1	1	1	1	1	6
NONE	OG0004780	1	1	1	1	1	1	6
NONE	OG0004781	1	1	1	1	1	1	6
NONE	OG0004782	1	1	1	1	1	1	6
NONE	OG0004783	2	1	0	1	1	1	6
NONE	OG0004784	1	1	1	1	1	1	6
NONE	OG0004785	1	1	1	1	1	1	6
NONE	OG0004786	1	1	1	1	1	1	6
NONE	OG0004787	1	1	1	1	1	1	6
NONE	OG0004788	3	0	2	1	0	0	6
NONE	OG0004789	1	1	1	1	1	1	6
NONE	OG0004790	1	1	1	1	1	1	6
NONE	OG0004791	1	1	1	1	1	1	6
NONE	OG0004792	1	1	1	1	1	1	6
NONE	OG0004793	1	1	1	1	1	1	6
NONE	OG0004794	1	1	1	1	1	1	6
NONE	OG0004795	1	1	1	1	2	0	6
NONE	OG0004796	4	0	2	0	0	0	6
NONE	OG0004797	1	1	2	1	1	0	6
NONE	OG0004798	5	0	1	0	0	0	6
NONE	OG0004799	2	1	1	1	1	0	6
NONE	OG0004800	2	1	1	1	1	0	6
NONE	OG0004801	2	1	1	1	1	0	6
NONE	OG0004802	1	1	1	1	1	1	6
NONE	OG0004803	1	1	1	1	1	1	6
NONE	OG0004804	1	1	1	1	1	1	6
NONE	OG0004805	1	1	1	1	1	1	6
NONE	OG0004806	1	0	1	2	1	1	6
NONE	OG0004807	1	1	1	1	1	1	6
NONE	OG0004808	1	1	1	1	1	1	6
NONE	OG0004809	1	1	1	1	1	1	6
NONE	OG0004810	1	1	1	1	1	1	6
NONE	OG0004811	1	1	1	1	1	1	6
NONE	OG0004812	1	1	1	1	1	1	6
NONE	OG0004813	1	1	1	1	1	1	6
NONE	OG0004814	1	1	1	1	1	1	6
NONE	OG0004815	1	1	1	1	1	1	6
NONE	OG0004816	1	1	1	1	1	1	6
NONE	OG0004817	1	1	1	1	1	1	6
NONE	OG0004818	1	1	1	1	1	1	6
NONE	OG0004819	1	1	1	1	1	1	6
NONE	OG0004820	1	1	1	1	1	1	6
NONE	OG0004821	1	1	1	1	1	1	6
NONE	OG0004822	1	1	1	1	1	1	6
NONE	OG0004823	1	1	1	1	1	1	6
NONE	OG0004824	1	1	1	1	1	1	6
NONE	OG0004825	1	1	1	1	1	1	6
NONE	OG0004826	1	1	1	1	1	1	6
NONE	OG0004827	1	1	1	1	1	1	6
NONE	OG0004828	1	1	1	1	1	1	6
NONE	OG0004829	1	1	1	1	1	1	6
NONE	OG0004830	1	1	1	1	1	1	6
NONE	OG0004831	1	1	1	1	1	1	6
NONE	OG0004832	1	1	1	1	1	1	6
NONE	OG0004833	1	1	1	1	0	2	6
NONE	OG0004834	1	1	1	1	1	1	6
NONE	OG0004835	1	1	1	1	1	1	6
NONE	OG0004836	1	1	1	1	1	1	6
NONE	OG0004837	1	1	1	1	1	1	6
NONE	OG0004838	1	1	1	1	1	1	6
NONE	OG0004839	1	1	1	1	1	1	6
NONE	OG0004840	1	1	1	1	1	1	6
NONE	OG0004841	1	1	1	1	1	1	6
NONE	OG0004842	1	1	1	1	1	1	6
NONE	OG0004843	1	1	1	1	1	1	6
NONE	OG0004844	1	1	1	1	1	1	6
NONE	OG0004845	1	1	1	1	1	1	6
NONE	OG0004846	1	1	1	1	1	1	6
NONE	OG0004847	1	1	1	1	1	1	6
NONE	OG0004848	1	1	1	1	1	1	6
NONE	OG0004849	1	1	1	1	1	1	6
NONE	OG0004850	6	0	0	0	0	0	6
NONE	OG0004851	1	1	1	1	1	1	6
NONE	OG0004852	1	0	1	1	2	1	6
NONE	OG0004853	1	1	1	1	1	1	6
NONE	OG0004854	1	1	1	1	1	1	6
NONE	OG0004855	1	1	1	1	1	1	6
NONE	OG0004856	1	1	1	1	1	1	6
NONE	OG0004857	1	1	1	1	1	1	6
NONE	OG0004858	1	0	1	2	1	1	6
NONE	OG0004859	1	0	2	2	0	1	6
NONE	OG0004860	1	0	2	3	0	0	6
NONE	OG0004861	1	0	2	3	0	0	6
NONE	OG0004862	1	1	1	1	1	1	6
NONE	OG0004863	1	1	1	1	1	1	6
NONE	OG0004864	1	1	1	1	1	1	6
NONE	OG0004865	1	1	1	1	1	1	6
NONE	OG0004866	1	1	1	1	1	1	6
NONE	OG0004867	1	1	1	1	1	1	6
NONE	OG0004868	1	1	1	1	1	1	6
NONE	OG0004869	2	1	1	1	0	1	6
NONE	OG0004870	1	1	1	1	1	1	6
NONE	OG0004871	1	1	1	1	1	1	6
NONE	OG0004872	1	1	1	1	1	1	6
NONE	OG0004873	1	1	1	1	1	1	6
NONE	OG0004874	1	1	1	1	1	1	6
NONE	OG0004875	1	1	1	1	1	1	6
NONE	OG0004876	1	1	1	1	1	1	6
NONE	OG0004877	1	1	1	1	1	1	6
NONE	OG0004878	1	1	1	1	1	1	6
NONE	OG0004879	1	1	1	1	1	1	6
NONE	OG0004880	1	1	1	1	1	1	6
NONE	OG0004881	1	1	1	1	1	1	6
NONE	OG0004882	1	1	1	1	1	1	6
NONE	OG0004883	1	1	1	1	1	1	6
NONE	OG0004884	1	1	1	1	1	1	6
NONE	OG0004885	1	1	1	1	1	1	6
NONE	OG0004886	1	1	1	1	1	1	6
NONE	OG0004887	1	0	2	1	1	1	6
NONE	OG0004888	6	0	0	0	0	0	6
NONE	OG0004889	1	1	1	1	1	1	6
NONE	OG0004890	1	1	1	1	1	1	6
NONE	OG0004891	1	1	1	1	1	1	6
NONE	OG0004892	1	1	1	1	1	1	6
NONE	OG0004893	1	1	1	1	1	1	6
NONE	OG0004894	1	1	1	1	1	1	6
NONE	OG0004895	1	1	1	1	1	1	6
NONE	OG0004896	1	1	1	1	1	1	6
NONE	OG0004897	1	1	1	1	1	1	6
NONE	OG0004898	2	1	1	1	0	1	6
NONE	OG0004899	1	1	1	1	1	1	6
NONE	OG0004900	1	1	1	1	1	1	6
NONE	OG0004901	1	1	1	1	1	1	6
NONE	OG0004902	1	1	1	1	1	1	6
NONE	OG0004903	1	1	1	1	1	1	6
NONE	OG0004904	1	1	1	1	1	1	6
NONE	OG0004905	1	1	1	1	1	1	6
NONE	OG0004906	1	1	1	1	1	1	6
NONE	OG0004907	2	1	1	1	0	1	6
NONE	OG0004908	6	0	0	0	0	0	6
NONE	OG0004909	1	1	1	1	1	1	6
NONE	OG0004910	1	1	1	1	1	1	6
NONE	OG0004911	1	1	1	1	1	1	6
NONE	OG0004912	1	1	1	1	1	1	6
NONE	OG0004913	1	1	1	1	1	1	6
NONE	OG0004914	1	1	1	1	1	1	6
NONE	OG0004915	1	1	1	1	1	1	6
NONE	OG0004916	1	1	1	1	1	1	6
NONE	OG0004917	1	1	1	1	1	1	6
NONE	OG0004918	1	1	1	1	1	1	6
NONE	OG0004919	2	0	1	1	1	1	6
NONE	OG0004920	1	1	1	1	1	1	6
NONE	OG0004921	1	1	1	1	1	1	6
NONE	OG0004922	1	1	1	1	1	1	6
NONE	OG0004923	1	1	1	1	1	1	6
NONE	OG0004924	1	1	1	1	1	1	6
NONE	OG0004925	1	1	1	1	1	1	6
NONE	OG0004926	1	1	1	1	1	1	6
NONE	OG0004927	1	1	1	1	1	1	6
NONE	OG0004928	1	1	1	1	1	1	6
NONE	OG0004929	1	1	1	1	1	1	6
NONE	OG0004930	1	1	1	1	1	1	6
NONE	OG0004931	1	1	1	1	1	1	6
NONE	OG0004932	1	1	1	1	1	1	6
NONE	OG0004933	1	1	1	1	1	1	6
NONE	OG0004934	1	1	1	1	1	1	6
NONE	OG0004935	1	1	1	1	1	1	6
NONE	OG0004936	1	1	1	1	1	1	6
NONE	OG0004937	1	0	3	2	0	0	6
NONE	OG0004938	1	1	1	1	1	1	6
NONE	OG0004939	1	1	1	1	1	1	6
NONE	OG0004940	1	0	1	1	2	1	6
NONE	OG0004941	1	1	1	1	1	1	6
NONE	OG0004942	2	0	1	1	1	1	6
NONE	OG0004943	2	1	1	1	0	1	6
NONE	OG0004944	6	0	0	0	0	0	6
NONE	OG0004945	1	1	1	1	1	1	6
NONE	OG0004946	1	1	1	1	1	1	6
NONE	OG0004947	1	1	1	1	1	1	6
NONE	OG0004948	1	1	1	1	1	1	6
NONE	OG0004949	1	1	1	1	1	1	6
NONE	OG0004950	1	1	1	1	1	1	6
NONE	OG0004951	1	1	1	1	1	1	6
NONE	OG0004952	1	1	1	1	1	1	6
NONE	OG0004953	1	1	1	1	1	1	6
NONE	OG0004954	1	1	1	1	1	1	6
NONE	OG0004955	1	1	1	1	1	1	6
NONE	OG0004956	1	1	1	1	1	1	6
NONE	OG0004957	1	1	1	1	1	1	6
NONE	OG0004958	1	1	1	1	1	1	6
NONE	OG0004959	1	1	1	1	1	1	6
NONE	OG0004960	1	1	1	1	1	1	6
NONE	OG0004961	1	1	1	1	1	1	6
NONE	OG0004962	1	1	1	1	1	1	6
NONE	OG0004963	1	0	1	1	2	1	6
NONE	OG0004964	1	1	1	1	1	1	6
NONE	OG0004965	1	1	1	1	1	1	6
NONE	OG0004966	1	1	1	1	1	1	6
NONE	OG0004967	1	1	1	1	1	1	6
NONE	OG0004968	1	1	1	1	1	1	6
NONE	OG0004969	2	0	1	2	0	1	6
NONE	OG0004970	1	1	1	1	1	1	6
NONE	OG0004971	1	1	1	1	1	1	6
NONE	OG0004972	1	1	1	1	1	1	6
NONE	OG0004973	1	1	1	1	1	1	6
NONE	OG0004974	1	1	1	1	1	1	6
NONE	OG0004975	1	1	1	1	1	1	6
NONE	OG0004976	1	1	1	1	1	1	6
NONE	OG0004977	1	1	1	1	1	1	6
NONE	OG0004978	1	1	1	1	1	1	6
NONE	OG0004979	2	1	1	1	0	1	6
NONE	OG0004980	1	1	1	1	1	1	6
NONE	OG0004981	1	1	1	1	1	1	6
NONE	OG0004982	2	0	1	1	1	1	6
NONE	OG0004983	1	1	1	1	1	1	6
NONE	OG0004984	6	0	0	0	0	0	6
NONE	OG0004985	2	0	2	1	0	1	6
NONE	OG0004986	1	1	1	1	1	1	6
NONE	OG0004987	1	1	1	1	1	1	6
NONE	OG0004988	1	1	1	1	1	1	6
NONE	OG0004989	1	1	1	1	1	1	6
NONE	OG0004990	1	1	1	1	1	1	6
NONE	OG0004991	4	0	1	1	0	0	6
NONE	OG0004992	2	1	1	1	0	1	6
NONE	OG0004993	1	0	1	1	2	1	6
NONE	OG0004994	4	0	0	2	0	0	6
NONE	OG0004995	1	1	1	1	1	1	6
NONE	OG0004996	1	1	1	1	1	1	6
NONE	OG0004997	1	1	1	1	1	1	6
NONE	OG0004998	1	1	1	1	1	1	6
NONE	OG0004999	1	1	1	1	1	1	6
NONE	OG0005000	1	1	1	1	1	1	6
NONE	OG0005001	1	1	1	1	1	1	6
NONE	OG0005002	1	1	1	1	1	1	6
NONE	OG0005003	1	1	1	1	1	1	6
NONE	OG0005004	1	1	1	1	1	1	6
NONE	OG0005005	1	1	1	1	1	1	6
NONE	OG0005006	1	1	1	1	1	1	6
NONE	OG0005007	1	1	1	1	1	1	6
NONE	OG0005008	1	1	1	1	1	1	6
NONE	OG0005009	1	1	1	1	1	1	6
NONE	OG0005010	1	1	1	1	1	1	6
NONE	OG0005011	1	1	1	1	1	1	6
NONE	OG0005012	1	1	1	1	1	1	6
NONE	OG0005013	1	1	1	1	1	1	6
NONE	OG0005014	1	1	1	1	1	1	6
NONE	OG0005015	1	1	1	1	1	1	6
NONE	OG0005016	1	1	1	1	1	1	6
NONE	OG0005017	1	0	1	1	2	1	6
NONE	OG0005018	1	1	1	1	1	1	6
NONE	OG0005019	1	1	1	1	1	1	6
NONE	OG0005020	1	1	1	1	1	1	6
NONE	OG0005021	1	1	1	1	1	1	6
NONE	OG0005022	1	1	1	1	1	1	6
NONE	OG0005023	1	1	1	1	1	1	6
NONE	OG0005024	1	1	1	1	1	1	6
NONE	OG0005025	1	1	1	1	1	1	6
NONE	OG0005026	1	1	1	1	1	1	6
NONE	OG0005027	1	1	1	1	1	1	6
NONE	OG0005028	1	1	1	1	1	1	6
NONE	OG0005029	1	1	1	1	1	1	6
NONE	OG0005030	1	1	1	1	1	1	6
NONE	OG0005031	1	1	1	1	1	1	6
NONE	OG0005032	1	1	1	1	1	1	6
NONE	OG0005033	1	1	1	1	1	1	6
NONE	OG0005034	1	0	1	1	2	1	6
NONE	OG0005035	1	1	1	1	1	1	6
NONE	OG0005036	1	1	1	1	1	1	6
NONE	OG0005037	1	1	1	1	1	1	6
NONE	OG0005038	1	1	1	1	1	1	6
NONE	OG0005039	1	1	1	1	1	1	6
NONE	OG0005040	1	2	1	1	0	1	6
NONE	OG0005041	1	1	1	1	1	1	6
NONE	OG0005042	1	1	1	1	1	1	6
NONE	OG0005043	1	1	1	1	1	1	6
NONE	OG0005044	2	0	1	1	0	2	6
NONE	OG0005045	2	1	1	1	0	1	6
NONE	OG0005046	1	1	1	1	1	1	6
NONE	OG0005047	1	2	1	1	1	0	6
NONE	OG0005048	1	1	2	1	1	0	6
NONE	OG0005049	1	1	1	1	1	1	6
NONE	OG0005050	1	1	1	1	1	1	6
NONE	OG0005051	1	1	1	1	1	1	6
NONE	OG0005052	1	1	1	1	1	1	6
NONE	OG0005053	1	1	1	1	1	1	6
NONE	OG0005054	1	1	1	1	1	1	6
NONE	OG0005055	2	1	2	0	0	1	6
NONE	OG0005056	1	1	1	1	1	1	6
NONE	OG0005057	1	1	1	1	1	1	6
NONE	OG0005058	1	1	1	1	1	1	6
NONE	OG0005059	1	1	1	1	1	1	6
NONE	OG0005060	1	1	1	1	1	1	6
NONE	OG0005061	1	1	1	1	1	1	6
NONE	OG0005062	1	1	1	1	1	1	6
NONE	OG0005063	1	1	1	1	1	1	6
NONE	OG0005064	1	0	1	1	2	1	6
NONE	OG0005065	1	1	1	1	1	1	6
NONE	OG0005066	1	1	1	1	1	1	6
NONE	OG0005067	1	1	1	1	1	1	6
NONE	OG0005068	1	1	1	1	1	1	6
NONE	OG0005069	1	1	1	1	1	1	6
NONE	OG0005070	1	1	1	1	1	1	6
NONE	OG0005071	1	1	1	1	1	1	6
NONE	OG0005072	1	1	1	1	1	1	6
NONE	OG0005073	1	1	1	1	1	1	6
NONE	OG0005074	1	1	1	1	1	1	6
NONE	OG0005075	1	1	1	1	1	1	6
NONE	OG0005076	1	1	1	1	1	1	6
NONE	OG0005077	1	1	1	1	1	1	6
NONE	OG0005078	1	1	1	1	1	1	6
NONE	OG0005079	2	0	4	0	0	0	6
NONE	OG0005080	1	1	1	1	1	1	6
NONE	OG0005081	1	1	1	1	1	1	6
NONE	OG0005082	1	1	1	1	1	1	6
NONE	OG0005083	1	1	1	1	1	1	6
NONE	OG0005084	1	1	1	1	1	1	6
NONE	OG0005085	1	1	1	1	1	1	6
NONE	OG0005086	1	1	1	1	1	1	6
NONE	OG0005087	1	1	1	1	1	1	6
NONE	OG0005088	1	1	1	1	1	1	6
NONE	OG0005089	1	1	1	1	1	1	6
NONE	OG0005090	1	1	1	1	1	1	6
NONE	OG0005091	1	1	1	1	1	1	6
NONE	OG0005092	1	1	1	1	1	1	6
NONE	OG0005093	1	1	1	1	1	1	6
NONE	OG0005094	1	1	1	1	1	1	6
NONE	OG0005095	1	1	1	1	1	1	6
NONE	OG0005096	1	1	1	1	1	1	6
NONE	OG0005097	2	0	1	1	1	1	6
NONE	OG0005098	1	0	1	2	1	1	6
NONE	OG0005099	1	1	1	1	1	1	6
NONE	OG0005100	1	1	1	1	1	1	6
NONE	OG0005101	2	0	1	2	0	1	6
NONE	OG0005102	1	1	1	1	1	1	6
NONE	OG0005103	1	1	1	1	1	1	6
NONE	OG0005104	1	1	1	1	1	1	6
NONE	OG0005105	1	1	1	1	1	1	6
NONE	OG0005106	1	1	1	1	1	1	6
NONE	OG0005107	1	1	1	1	1	1	6
NONE	OG0005108	1	1	1	1	1	1	6
NONE	OG0005109	1	1	1	1	1	1	6
NONE	OG0005110	1	1	1	1	1	1	6
NONE	OG0005111	1	1	1	1	1	1	6
NONE	OG0005112	1	1	1	1	1	1	6
NONE	OG0005113	1	1	1	1	1	1	6
NONE	OG0005114	1	1	1	1	1	1	6
NONE	OG0005115	1	1	1	1	1	1	6
NONE	OG0005116	1	1	1	1	1	1	6
NONE	OG0005117	1	0	2	0	0	3	6
NONE	OG0005118	1	1	1	1	1	1	6
NONE	OG0005119	1	1	1	1	1	1	6
NONE	OG0005120	1	1	1	1	1	1	6
NONE	OG0005121	1	1	1	1	1	1	6
NONE	OG0005122	1	1	1	1	1	1	6
NONE	OG0005123	1	1	1	1	1	1	6
NONE	OG0005124	1	1	1	1	1	1	6
NONE	OG0005125	1	1	1	1	1	1	6
NONE	OG0005126	1	1	1	1	1	1	6
NONE	OG0005127	1	1	1	1	1	1	6
NONE	OG0005128	1	1	1	1	1	1	6
NONE	OG0005129	1	1	1	1	1	1	6
NONE	OG0005130	1	1	1	1	1	1	6
NONE	OG0005131	1	1	1	1	1	1	6
NONE	OG0005132	1	1	1	1	1	1	6
NONE	OG0005133	1	1	1	2	0	1	6
NONE	OG0005134	1	1	1	1	1	1	6
NONE	OG0005135	1	1	1	1	1	1	6
NONE	OG0005136	1	1	1	1	1	1	6
NONE	OG0005137	1	1	1	1	1	1	6
NONE	OG0005138	1	1	1	1	1	1	6
NONE	OG0005139	1	1	1	1	1	1	6
NONE	OG0005140	1	1	1	1	1	1	6
NONE	OG0005141	1	1	1	1	1	1	6
NONE	OG0005142	1	1	1	1	1	1	6
NONE	OG0005143	1	1	1	1	1	1	6
NONE	OG0005144	1	1	1	1	1	1	6
NONE	OG0005145	1	1	1	1	1	1	6
NONE	OG0005146	1	1	1	1	1	1	6
NONE	OG0005147	1	1	1	1	1	1	6
NONE	OG0005148	2	1	1	1	0	1	6
NONE	OG0005149	1	1	1	1	1	1	6
NONE	OG0005150	1	1	1	1	1	1	6
NONE	OG0005151	1	1	1	1	1	1	6
NONE	OG0005152	1	1	1	1	1	1	6
NONE	OG0005153	1	1	1	1	1	1	6
NONE	OG0005154	1	1	1	1	1	1	6
NONE	OG0005155	1	1	1	1	1	1	6
NONE	OG0005156	1	1	1	1	1	1	6
NONE	OG0005157	1	1	1	1	1	1	6
NONE	OG0005158	1	1	1	1	1	1	6
NONE	OG0005159	1	1	1	1	1	1	6
NONE	OG0005160	1	1	1	1	1	1	6
NONE	OG0005161	1	1	1	1	1	1	6
NONE	OG0005162	1	0	0	0	5	0	6
NONE	OG0005163	1	1	1	1	1	1	6
NONE	OG0005164	2	1	2	1	0	0	6
NONE	OG0005165	3	0	3	0	0	0	6
NONE	OG0005166	1	0	1	4	0	0	6
NONE	OG0005167	1	1	1	1	1	1	6
NONE	OG0005168	1	1	1	1	1	1	6
NONE	OG0005169	1	1	1	1	1	1	6
NONE	OG0005170	1	1	1	1	1	1	6
NONE	OG0005171	1	1	1	1	1	1	6
NONE	OG0005172	1	1	1	1	1	1	6
NONE	OG0005173	1	1	1	1	1	1	6
NONE	OG0005174	1	1	1	1	1	1	6
NONE	OG0005175	1	1	1	1	1	1	6
NONE	OG0005176	1	1	1	1	1	1	6
NONE	OG0005177	1	1	1	1	1	1	6
NONE	OG0005178	1	1	1	1	1	1	6
NONE	OG0005179	1	1	1	1	1	1	6
NONE	OG0005180	1	1	1	1	1	1	6
NONE	OG0005181	1	1	1	1	1	1	6
NONE	OG0005182	1	1	1	1	1	1	6
NONE	OG0005183	1	1	1	1	1	1	6
NONE	OG0005184	1	1	1	1	1	1	6
NONE	OG0005185	1	1	2	1	0	1	6
NONE	OG0005186	6	0	0	0	0	0	6
NONE	OG0005187	1	1	1	1	1	1	6
NONE	OG0005188	2	0	0	4	0	0	6
NONE	OG0005189	1	1	1	1	1	1	6
NONE	OG0005190	1	1	1	1	1	1	6
NONE	OG0005191	1	1	1	1	1	1	6
NONE	OG0005192	1	1	1	1	1	1	6
NONE	OG0005193	1	1	1	1	1	1	6
NONE	OG0005194	2	0	2	1	0	1	6
NONE	OG0005195	1	1	1	1	1	1	6
NONE	OG0005196	1	1	1	1	1	1	6
NONE	OG0005197	1	1	1	1	1	1	6
NONE	OG0005198	1	1	1	1	1	1	6
NONE	OG0005199	1	0	1	2	1	1	6
NONE	OG0005200	1	1	1	2	0	1	6
NONE	OG0005201	1	1	2	1	0	1	6
NONE	OG0005202	1	1	2	1	0	1	6
NONE	OG0005203	1	1	1	1	1	1	6
NONE	OG0005204	1	1	1	1	1	1	6
NONE	OG0005205	1	0	4	0	0	1	6
NONE	OG0005206	1	1	1	1	1	1	6
NONE	OG0005207	1	1	1	1	1	1	6
NONE	OG0005208	1	1	1	1	1	1	6
NONE	OG0005209	1	1	1	1	1	1	6
NONE	OG0005210	1	2	1	1	0	1	6
NONE	OG0005211	1	1	1	1	1	1	6
NONE	OG0005212	1	1	1	1	1	1	6
NONE	OG0005213	1	1	1	1	1	1	6
NONE	OG0005214	1	1	1	1	1	1	6
NONE	OG0005215	1	1	1	1	1	1	6
NONE	OG0005216	1	1	1	1	1	1	6
NONE	OG0005217	1	1	1	1	1	1	6
NONE	OG0005218	1	1	1	1	1	1	6
NONE	OG0005219	1	1	1	1	1	1	6
NONE	OG0005220	1	1	1	1	1	1	6
NONE	OG0005221	1	1	1	1	1	1	6
NONE	OG0005222	1	1	1	1	1	1	6
NONE	OG0005223	5	0	1	0	0	0	6
NONE	OG0005224	1	1	1	1	1	1	6
NONE	OG0005225	1	1	1	1	1	1	6
NONE	OG0005226	1	1	1	1	1	1	6
NONE	OG0005227	1	1	1	1	1	1	6
NONE	OG0005228	1	1	1	1	1	1	6
NONE	OG0005229	1	1	1	1	1	1	6
NONE	OG0005230	1	1	1	1	1	1	6
NONE	OG0005231	1	1	1	1	1	1	6
NONE	OG0005232	1	1	1	1	1	1	6
NONE	OG0005233	1	1	1	1	1	1	6
NONE	OG0005234	1	1	1	1	1	1	6
NONE	OG0005235	1	1	1	1	1	1	6
NONE	OG0005236	1	1	1	1	1	1	6
NONE	OG0005237	1	1	1	1	1	1	6
NONE	OG0005238	1	1	1	1	1	1	6
NONE	OG0005239	1	1	1	1	1	1	6
NONE	OG0005240	1	1	1	1	1	1	6
NONE	OG0005241	1	1	1	1	1	1	6
NONE	OG0005242	1	1	1	1	1	1	6
NONE	OG0005243	1	1	1	1	1	1	6
NONE	OG0005244	1	1	1	1	1	1	6
NONE	OG0005245	1	1	1	1	1	1	6
NONE	OG0005246	1	1	1	1	1	1	6
NONE	OG0005247	1	1	1	1	1	1	6
NONE	OG0005248	1	1	1	1	1	1	6
NONE	OG0005249	1	1	1	1	1	1	6
NONE	OG0005250	1	1	1	1	1	1	6
NONE	OG0005251	1	1	1	1	1	1	6
NONE	OG0005252	1	1	1	1	1	1	6
NONE	OG0005253	1	1	1	1	1	1	6
NONE	OG0005254	1	1	1	1	1	1	6
NONE	OG0005255	1	1	1	1	1	1	6
NONE	OG0005256	1	1	1	1	1	1	6
NONE	OG0005257	1	1	1	1	1	1	6
NONE	OG0005258	1	1	1	1	1	1	6
NONE	OG0005259	1	1	1	1	1	1	6
NONE	OG0005260	1	1	1	1	1	1	6
NONE	OG0005261	1	1	1	1	1	1	6
NONE	OG0005262	1	1	1	1	1	1	6
NONE	OG0005263	1	1	1	1	1	1	6
NONE	OG0005264	2	1	1	1	0	1	6
NONE	OG0005265	2	1	1	0	1	1	6
NONE	OG0005266	1	1	1	1	1	1	6
NONE	OG0005267	1	1	1	1	1	1	6
NONE	OG0005268	1	1	1	1	1	1	6
NONE	OG0005269	1	1	1	1	1	1	6
NONE	OG0005270	1	1	1	1	1	1	6
NONE	OG0005271	2	0	1	1	1	1	6
NONE	OG0005272	1	1	1	1	1	1	6
NONE	OG0005273	1	1	1	1	1	1	6
NONE	OG0005274	1	1	1	1	1	1	6
NONE	OG0005275	1	1	1	1	1	1	6
NONE	OG0005276	1	1	1	1	1	1	6
NONE	OG0005277	1	1	1	1	1	1	6
NONE	OG0005278	1	0	1	1	2	1	6
NONE	OG0005279	1	1	1	1	1	1	6
NONE	OG0005280	1	1	1	1	1	1	6
NONE	OG0005281	1	1	1	1	1	1	6
NONE	OG0005282	1	1	1	1	1	1	6
NONE	OG0005283	1	1	1	1	1	1	6
NONE	OG0005284	1	1	1	1	1	1	6
NONE	OG0005285	1	1	1	1	1	1	6
NONE	OG0005286	1	1	1	1	1	1	6
NONE	OG0005287	1	1	1	1	1	1	6
NONE	OG0005288	1	1	1	1	1	1	6
NONE	OG0005289	1	1	1	1	1	1	6
NONE	OG0005290	2	0	1	1	1	1	6
NONE	OG0005291	1	1	1	1	1	1	6
NONE	OG0005292	1	1	1	1	1	1	6
NONE	OG0005293	1	1	1	1	1	1	6
NONE	OG0005294	1	1	1	1	1	1	6
NONE	OG0005295	1	1	1	1	1	1	6
NONE	OG0005296	1	1	1	1	1	1	6
NONE	OG0005297	1	0	1	1	2	1	6
NONE	OG0005298	1	1	1	1	1	1	6
NONE	OG0005299	1	0	1	2	1	1	6
NONE	OG0005300	1	1	1	1	1	1	6
NONE	OG0005301	1	1	1	1	1	1	6
NONE	OG0005302	1	1	1	1	1	1	6
NONE	OG0005303	1	1	1	1	1	1	6
NONE	OG0005304	1	1	1	1	1	1	6
NONE	OG0005305	1	1	1	1	1	1	6
NONE	OG0005306	1	1	1	1	1	1	6
NONE	OG0005307	1	1	1	1	1	1	6
NONE	OG0005308	1	1	1	1	1	1	6
NONE	OG0005309	2	0	1	1	1	1	6
NONE	OG0005310	1	1	1	1	1	1	6
NONE	OG0005311	1	1	1	1	1	1	6
NONE	OG0005312	1	0	2	1	1	1	6
NONE	OG0005313	1	1	1	1	1	1	6
NONE	OG0005314	1	1	1	1	1	1	6
NONE	OG0005315	1	1	1	1	1	1	6
NONE	OG0005316	1	1	1	1	1	1	6
NONE	OG0005317	1	1	1	1	1	1	6
NONE	OG0005318	1	1	1	1	1	1	6
NONE	OG0005319	1	1	1	1	1	1	6
NONE	OG0005320	1	1	1	1	1	1	6
NONE	OG0005321	1	1	1	1	1	1	6
NONE	OG0005322	1	1	1	1	1	1	6
NONE	OG0005323	1	1	1	1	1	1	6
NONE	OG0005324	2	0	1	1	1	1	6
NONE	OG0005325	1	1	1	1	1	1	6
NONE	OG0005326	1	1	1	1	1	1	6
NONE	OG0005327	1	1	1	1	1	1	6
NONE	OG0005328	1	1	1	1	1	1	6
NONE	OG0005329	1	1	1	1	1	1	6
NONE	OG0005330	1	1	1	1	1	1	6
NONE	OG0005331	1	1	1	1	1	1	6
NONE	OG0005332	1	1	1	1	1	1	6
NONE	OG0005333	1	1	1	1	1	1	6
NONE	OG0005334	1	1	1	1	1	1	6
NONE	OG0005335	1	1	1	1	1	1	6
NONE	OG0005336	1	1	1	1	1	1	6
NONE	OG0005337	1	1	1	1	1	1	6
NONE	OG0005338	1	1	1	1	1	1	6
NONE	OG0005339	1	1	1	1	1	1	6
NONE	OG0005340	1	1	1	1	1	1	6
NONE	OG0005341	1	1	1	1	1	1	6
NONE	OG0005342	1	1	1	1	1	1	6
NONE	OG0005343	1	1	1	1	1	1	6
NONE	OG0005344	1	1	1	1	1	1	6
NONE	OG0005345	1	1	1	1	1	1	6
NONE	OG0005346	1	1	1	1	1	1	6
NONE	OG0005347	1	1	1	1	1	1	6
NONE	OG0005348	1	1	1	1	1	1	6
NONE	OG0005349	1	1	1	1	1	1	6
NONE	OG0005350	1	1	1	1	1	1	6
NONE	OG0005351	1	1	1	1	1	1	6
NONE	OG0005352	1	1	1	1	1	1	6
NONE	OG0005353	1	1	1	1	1	1	6
NONE	OG0005354	1	1	1	1	1	1	6
NONE	OG0005355	1	1	1	1	1	1	6
NONE	OG0005356	1	0	2	1	1	1	6
NONE	OG0005357	1	1	1	1	1	1	6
NONE	OG0005358	1	0	2	1	1	1	6
NONE	OG0005359	1	1	1	1	1	1	6
NONE	OG0005360	1	1	1	1	1	1	6
NONE	OG0005361	1	1	1	1	1	1	6
NONE	OG0005362	1	1	1	1	1	1	6
NONE	OG0005363	1	1	1	1	1	1	6
NONE	OG0005364	1	1	1	1	1	1	6
NONE	OG0005365	1	1	1	1	1	1	6
NONE	OG0005366	1	1	1	1	1	1	6
NONE	OG0005367	1	1	1	1	1	1	6
NONE	OG0005368	1	1	1	1	1	1	6
NONE	OG0005369	1	1	1	1	1	1	6
NONE	OG0005370	1	1	1	1	1	1	6
NONE	OG0005371	1	1	1	1	1	1	6
NONE	OG0005372	1	1	1	1	1	1	6
NONE	OG0005373	1	1	1	1	1	1	6
NONE	OG0005374	1	1	1	1	1	1	6
NONE	OG0005375	1	1	1	1	1	1	6
NONE	OG0005376	1	1	1	1	1	1	6
NONE	OG0005377	1	1	1	1	1	1	6
NONE	OG0005378	1	1	1	1	1	1	6
NONE	OG0005379	1	1	1	1	1	1	6
NONE	OG0005380	1	1	1	1	1	1	6
NONE	OG0005381	1	1	1	1	1	1	6
NONE	OG0005382	1	0	4	1	0	0	6
NONE	OG0005383	2	1	1	1	0	1	6
NONE	OG0005384	1	1	1	1	1	1	6
NONE	OG0005385	1	1	2	1	0	1	6
NONE	OG0005386	1	1	2	1	1	0	6
NONE	OG0005387	1	1	1	1	1	1	6
NONE	OG0005388	1	1	1	1	1	1	6
NONE	OG0005389	1	1	1	1	1	1	6
NONE	OG0005390	1	1	1	1	1	1	6
NONE	OG0005391	1	1	1	1	1	1	6
NONE	OG0005392	1	1	1	1	1	1	6
NONE	OG0005393	1	1	1	1	1	1	6
NONE	OG0005394	1	1	1	1	1	1	6
NONE	OG0005395	1	1	1	1	1	1	6
NONE	OG0005396	1	1	1	1	1	1	6
NONE	OG0005397	1	1	1	1	1	1	6
NONE	OG0005398	1	1	1	1	1	1	6
NONE	OG0005399	1	1	1	1	1	1	6
NONE	OG0005400	1	1	1	1	1	1	6
NONE	OG0005401	1	1	1	1	1	1	6
NONE	OG0005402	1	1	1	1	1	1	6
NONE	OG0005403	4	0	1	1	0	0	6
NONE	OG0005404	1	1	1	1	1	1	6
NONE	OG0005405	1	1	1	1	1	1	6
NONE	OG0005406	1	1	1	1	1	1	6
NONE	OG0005407	1	1	1	1	1	1	6
NONE	OG0005408	1	1	1	1	1	1	6
NONE	OG0005409	1	1	1	1	1	1	6
NONE	OG0005410	1	1	1	1	1	1	6
NONE	OG0005411	1	1	1	1	1	1	6
NONE	OG0005412	1	0	1	2	1	1	6
NONE	OG0005413	1	1	1	1	1	1	6
NONE	OG0005414	1	1	1	1	1	1	6
NONE	OG0005415	1	1	1	1	1	1	6
NONE	OG0005416	1	1	1	1	1	1	6
NONE	OG0005417	1	1	1	1	1	1	6
NONE	OG0005418	1	1	1	1	1	1	6
NONE	OG0005419	1	1	1	1	1	1	6
NONE	OG0005420	1	1	1	1	1	1	6
NONE	OG0005421	1	0	2	1	1	1	6
NONE	OG0005422	1	1	1	1	1	1	6
NONE	OG0005423	1	1	1	1	1	1	6
NONE	OG0005424	1	1	1	1	1	1	6
NONE	OG0005425	1	1	1	1	1	1	6
NONE	OG0005426	1	1	1	1	1	1	6
NONE	OG0005427	1	1	1	1	1	1	6
NONE	OG0005428	1	1	1	1	1	1	6
NONE	OG0005429	2	0	1	1	1	1	6
NONE	OG0005430	3	0	1	1	0	1	6
NONE	OG0005431	1	1	1	1	1	1	6
NONE	OG0005432	1	1	1	1	1	1	6
NONE	OG0005433	1	1	1	1	1	1	6
NONE	OG0005434	1	1	1	1	1	1	6
NONE	OG0005435	1	0	2	1	1	1	6
NONE	OG0005436	1	1	1	1	1	1	6
NONE	OG0005437	1	1	1	1	1	1	6
NONE	OG0005438	1	1	1	1	1	1	6
NONE	OG0005439	1	1	1	1	1	1	6
NONE	OG0005440	1	1	1	1	1	1	6
NONE	OG0005441	1	1	1	1	1	1	6
NONE	OG0005442	1	1	1	1	1	1	6
NONE	OG0005443	2	0	1	1	1	1	6
NONE	OG0005444	2	1	1	1	0	1	6
NONE	OG0005445	1	1	1	1	1	1	6
NONE	OG0005446	1	1	1	1	1	1	6
NONE	OG0005447	2	0	1	1	1	1	6
NONE	OG0005448	2	1	1	1	0	1	6
NONE	OG0005449	1	1	1	1	1	1	6
NONE	OG0005450	1	1	1	1	1	1	6
NONE	OG0005451	2	0	1	1	1	1	6
NONE	OG0005452	1	1	1	1	1	1	6
NONE	OG0005453	1	1	1	1	1	1	6
NONE	OG0005454	1	1	1	1	1	1	6
NONE	OG0005455	3	0	0	0	0	3	6
NONE	OG0005456	1	1	1	1	1	1	6
NONE	OG0005457	1	1	1	1	1	1	6
NONE	OG0005458	1	1	1	1	1	1	6
NONE	OG0005459	1	1	1	1	1	1	6
NONE	OG0005460	1	1	1	1	1	1	6
NONE	OG0005461	1	1	1	1	1	1	6
NONE	OG0005462	2	1	1	1	0	1	6
NONE	OG0005463	2	0	1	1	1	1	6
NONE	OG0005464	1	1	1	1	1	1	6
NONE	OG0005465	2	0	1	1	1	1	6
NONE	OG0005466	6	0	0	0	0	0	6
NONE	OG0005467	1	1	1	1	1	1	6
NONE	OG0005468	1	1	1	1	1	1	6
NONE	OG0005469	1	1	1	1	1	1	6
NONE	OG0005470	1	1	1	1	1	1	6
NONE	OG0005471	1	1	1	1	1	1	6
NONE	OG0005472	1	1	1	1	1	1	6
NONE	OG0005473	1	1	1	1	1	1	6
NONE	OG0005474	1	1	1	1	1	1	6
NONE	OG0005475	1	1	1	1	1	1	6
NONE	OG0005476	1	1	1	1	1	1	6
NONE	OG0005477	1	1	1	1	1	1	6
NONE	OG0005478	2	0	1	1	1	1	6
NONE	OG0005479	1	1	1	1	1	1	6
NONE	OG0005480	1	0	2	1	1	1	6
NONE	OG0005481	1	1	1	1	1	1	6
NONE	OG0005482	1	1	1	1	1	1	6
NONE	OG0005483	1	1	1	1	1	1	6
NONE	OG0005484	1	1	1	1	1	1	6
NONE	OG0005485	1	1	1	1	1	1	6
NONE	OG0005486	1	0	4	0	0	1	6
NONE	OG0005487	1	1	1	1	1	1	6
NONE	OG0005488	1	1	1	1	1	1	6
NONE	OG0005489	1	1	1	1	1	1	6
NONE	OG0005490	1	1	1	1	1	1	6
NONE	OG0005491	1	1	1	1	1	1	6
NONE	OG0005492	1	1	1	1	1	1	6
NONE	OG0005493	1	1	1	1	1	1	6
NONE	OG0005494	1	1	1	1	1	1	6
NONE	OG0005495	1	1	1	1	1	1	6
NONE	OG0005496	1	1	1	1	1	1	6
NONE	OG0005497	1	1	1	1	1	1	6
NONE	OG0005498	1	1	1	1	1	1	6
NONE	OG0005499	1	1	1	1	1	1	6
NONE	OG0005500	1	1	1	1	1	1	6
NONE	OG0005501	1	1	1	1	1	1	6
NONE	OG0005502	2	0	1	1	1	1	6
NONE	OG0005503	1	1	1	1	1	1	6
NONE	OG0005504	1	1	1	1	1	1	6
NONE	OG0005505	1	1	1	1	1	1	6
NONE	OG0005506	1	1	1	1	1	1	6
NONE	OG0005507	1	1	1	1	1	1	6
NONE	OG0005508	1	1	1	1	1	1	6
NONE	OG0005509	1	1	1	1	1	1	6
NONE	OG0005510	1	1	1	1	1	1	6
NONE	OG0005511	1	1	1	1	1	1	6
NONE	OG0005512	1	1	1	1	1	1	6
NONE	OG0005513	1	1	1	1	1	1	6
NONE	OG0005514	1	1	1	1	1	1	6
NONE	OG0005515	3	0	2	0	1	0	6
NONE	OG0005516	2	0	2	0	0	2	6
NONE	OG0005517	1	0	2	1	1	1	6
NONE	OG0005518	3	0	1	0	0	2	6
NONE	OG0005519	1	1	1	1	1	1	6
NONE	OG0005520	1	1	1	1	1	1	6
NONE	OG0005521	1	1	1	1	1	1	6
NONE	OG0005522	1	1	1	1	1	1	6
NONE	OG0005523	1	1	1	1	1	1	6
NONE	OG0005524	1	1	1	1	1	1	6
NONE	OG0005525	1	1	1	1	1	1	6
NONE	OG0005526	1	1	1	1	1	1	6
NONE	OG0005527	1	1	1	1	1	1	6
NONE	OG0005528	1	1	1	1	1	1	6
NONE	OG0005529	1	1	2	1	0	1	6
NONE	OG0005530	1	1	1	1	1	1	6
NONE	OG0005531	1	1	1	1	1	1	6
NONE	OG0005532	1	1	1	1	1	1	6
NONE	OG0005533	1	1	1	1	1	1	6
NONE	OG0005534	1	1	1	1	1	1	6
NONE	OG0005535	1	1	1	1	1	1	6
NONE	OG0005536	1	1	1	1	1	1	6
NONE	OG0005537	1	1	1	1	1	1	6
NONE	OG0005538	1	1	1	1	1	1	6
NONE	OG0005539	1	1	1	1	1	1	6
NONE	OG0005540	2	1	1	1	0	1	6
NONE	OG0005541	1	1	1	1	1	1	6
NONE	OG0005542	1	1	1	1	1	1	6
NONE	OG0005543	2	1	1	1	0	1	6
NONE	OG0005544	2	0	1	1	1	1	6
NONE	OG0005545	1	1	1	1	1	1	6
NONE	OG0005546	1	1	1	1	1	1	6
NONE	OG0005547	1	1	1	1	1	1	6
NONE	OG0005548	2	0	2	1	0	1	6
NONE	OG0005549	1	0	1	2	1	1	6
NONE	OG0005550	1	1	1	1	1	1	6
NONE	OG0005551	1	1	1	1	1	1	6
NONE	OG0005552	1	1	1	1	1	1	6
NONE	OG0005553	1	0	3	1	0	1	6
NONE	OG0005554	1	1	1	1	1	1	6
NONE	OG0005555	1	1	1	1	1	1	6
NONE	OG0005556	1	1	1	1	1	1	6
NONE	OG0005557	1	1	1	1	1	1	6
NONE	OG0005558	1	1	1	1	1	1	6
NONE	OG0005559	1	1	1	1	1	1	6
NONE	OG0005560	1	1	1	1	1	1	6
NONE	OG0005561	2	1	1	1	0	1	6
NONE	OG0005562	1	1	1	1	1	1	6
NONE	OG0005563	2	0	1	1	1	1	6
NONE	OG0005564	2	1	0	1	1	1	6
NONE	OG0005565	2	1	0	2	0	1	6
NONE	OG0005566	1	1	1	1	1	1	6
NONE	OG0005567	1	1	1	1	1	1	6
NONE	OG0005568	1	0	2	2	0	1	6
NONE	OG0005569	1	1	1	1	1	1	6
NONE	OG0005570	1	1	1	1	1	1	6
NONE	OG0005571	1	1	1	1	1	1	6
NONE	OG0005572	1	1	1	1	1	1	6
NONE	OG0005573	1	1	1	1	1	1	6
NONE	OG0005574	1	1	1	1	1	1	6
NONE	OG0005575	1	1	1	1	1	1	6
NONE	OG0005576	2	1	1	1	0	1	6
NONE	OG0005577	2	1	1	1	0	1	6
NONE	OG0005578	1	1	1	1	1	1	6
NONE	OG0005579	1	1	1	1	1	1	6
NONE	OG0005580	1	1	1	1	1	1	6
NONE	OG0005581	1	2	1	1	0	1	6
NONE	OG0005582	1	1	1	1	1	1	6
NONE	OG0005583	1	1	1	1	1	1	6
NONE	OG0005584	1	1	1	1	1	1	6
NONE	OG0005585	1	1	1	1	1	1	6
NONE	OG0005586	1	1	1	1	1	1	6
NONE	OG0005587	1	1	1	1	1	1	6
NONE	OG0005588	1	1	1	1	1	1	6
NONE	OG0005589	2	0	1	1	1	1	6
NONE	OG0005590	1	1	1	1	1	1	6
NONE	OG0005591	1	1	1	1	1	1	6
NONE	OG0005592	1	1	1	1	1	1	6
NONE	OG0005593	1	1	1	1	1	1	6
NONE	OG0005594	1	1	1	1	1	1	6
NONE	OG0005595	1	2	1	1	0	1	6
NONE	OG0005596	1	1	1	1	1	1	6
NONE	OG0005597	1	1	1	1	1	1	6
NONE	OG0005598	1	1	1	1	1	1	6
NONE	OG0005599	1	1	1	1	1	1	6
NONE	OG0005600	2	1	1	1	0	1	6
NONE	OG0005601	1	1	1	1	1	1	6
NONE	OG0005602	1	1	1	1	1	1	6
NONE	OG0005603	1	1	1	1	1	1	6
NONE	OG0005604	1	1	1	1	1	1	6
NONE	OG0005605	1	1	1	1	1	1	6
NONE	OG0005606	1	1	1	1	1	1	6
NONE	OG0005607	1	1	1	1	1	1	6
NONE	OG0005608	1	1	1	1	1	1	6
NONE	OG0005609	1	1	1	1	1	1	6
NONE	OG0005610	1	1	1	1	1	1	6
NONE	OG0005611	1	1	1	1	1	1	6
NONE	OG0005612	1	1	1	1	1	1	6
NONE	OG0005613	1	1	1	1	1	1	6
NONE	OG0005614	1	1	1	1	1	1	6
NONE	OG0005615	1	1	1	1	1	1	6
NONE	OG0005616	1	1	1	1	1	1	6
NONE	OG0005617	1	1	1	1	1	1	6
NONE	OG0005618	1	1	1	1	1	1	6
NONE	OG0005619	1	1	1	1	1	1	6
NONE	OG0005620	1	1	1	1	1	1	6
NONE	OG0005621	1	1	1	1	1	1	6
NONE	OG0005622	1	1	1	1	1	1	6
NONE	OG0005623	1	1	1	1	1	1	6
NONE	OG0005624	1	1	2	1	0	1	6
NONE	OG0005625	1	1	1	1	1	1	6
NONE	OG0005626	1	1	1	1	1	1	6
NONE	OG0005627	1	1	1	1	1	1	6
NONE	OG0005628	1	1	1	1	1	1	6
NONE	OG0005629	1	1	1	1	1	1	6
NONE	OG0005630	1	1	1	1	1	1	6
NONE	OG0005631	2	0	2	1	0	1	6
NONE	OG0005632	1	1	1	1	1	1	6
NONE	OG0005633	1	1	2	1	0	1	6
NONE	OG0005634	1	1	1	1	1	1	6
NONE	OG0005635	1	1	1	1	1	1	6
NONE	OG0005636	1	1	1	1	1	1	6
NONE	OG0005637	1	1	1	1	1	1	6
NONE	OG0005638	1	1	1	1	1	1	6
NONE	OG0005639	1	1	1	1	1	1	6
NONE	OG0005640	1	1	1	1	1	1	6
NONE	OG0005641	1	1	1	1	1	1	6
NONE	OG0005642	1	1	1	1	1	1	6
NONE	OG0005643	1	1	1	1	0	2	6
NONE	OG0005644	1	1	1	1	1	1	6
NONE	OG0005645	1	1	1	1	1	1	6
NONE	OG0005646	1	1	1	1	1	1	6
NONE	OG0005647	1	1	1	1	1	1	6
NONE	OG0005648	1	0	1	1	1	2	6
NONE	OG0005649	1	1	1	1	1	1	6
NONE	OG0005650	1	1	1	2	0	1	6
NONE	OG0005651	1	1	1	1	1	1	6
NONE	OG0005652	1	1	1	1	1	1	6
NONE	OG0005653	1	1	1	1	1	1	6
NONE	OG0005654	2	0	1	1	1	1	6
NONE	OG0005655	1	1	1	1	1	1	6
NONE	OG0005656	1	1	1	1	1	1	6
NONE	OG0005657	1	1	1	1	1	1	6
NONE	OG0005658	1	1	1	1	1	1	6
NONE	OG0005659	1	0	2	0	0	3	6
NONE	OG0005660	1	0	1	2	1	1	6
NONE	OG0005661	1	1	1	1	1	1	6
NONE	OG0005662	1	1	1	1	1	1	6
NONE	OG0005663	1	1	1	1	1	1	6
NONE	OG0005664	1	1	1	1	1	1	6
NONE	OG0005665	1	1	1	1	1	1	6
NONE	OG0005666	1	1	1	1	1	1	6
NONE	OG0005667	1	1	1	1	1	1	6
NONE	OG0005668	1	1	1	1	1	1	6
NONE	OG0005669	1	1	1	1	1	1	6
NONE	OG0005670	1	1	1	1	1	1	6
NONE	OG0005671	1	1	1	1	1	1	6
NONE	OG0005672	1	1	1	1	1	1	6
NONE	OG0005673	1	1	1	1	1	1	6
NONE	OG0005674	1	1	1	1	1	1	6
NONE	OG0005675	1	1	1	1	1	1	6
NONE	OG0005676	1	1	1	1	1	1	6
NONE	OG0005677	1	1	1	1	1	1	6
NONE	OG0005678	1	1	1	1	1	1	6
NONE	OG0005679	1	1	1	1	1	1	6
NONE	OG0005680	1	1	1	1	1	1	6
NONE	OG0005681	1	1	1	1	1	1	6
NONE	OG0005682	1	1	1	1	1	1	6
NONE	OG0005683	1	1	1	1	1	1	6
NONE	OG0005684	1	1	1	1	1	1	6
NONE	OG0005685	1	1	1	1	1	1	6
NONE	OG0005686	1	1	1	1	1	1	6
NONE	OG0005687	1	1	1	1	1	1	6
NONE	OG0005688	1	1	1	1	1	1	6
NONE	OG0005689	1	1	1	1	1	1	6
NONE	OG0005690	1	0	2	1	1	1	6
NONE	OG0005691	1	1	1	1	1	1	6
NONE	OG0005692	1	1	1	1	1	1	6
NONE	OG0005693	1	1	1	1	1	1	6
NONE	OG0005694	1	1	1	1	1	1	6
NONE	OG0005695	1	1	1	1	1	1	6
NONE	OG0005696	1	1	1	1	1	1	6
NONE	OG0005697	2	0	1	1	1	1	6
NONE	OG0005698	2	0	1	1	1	1	6
NONE	OG0005699	1	1	1	1	1	1	6
NONE	OG0005700	1	1	1	1	1	1	6
NONE	OG0005701	2	0	2	1	0	1	6
NONE	OG0005702	1	1	1	1	1	1	6
NONE	OG0005703	1	1	1	1	1	1	6
NONE	OG0005704	1	1	1	1	1	1	6
NONE	OG0005705	1	1	1	1	1	1	6
NONE	OG0005706	1	1	1	1	1	1	6
NONE	OG0005707	1	1	1	1	1	1	6
NONE	OG0005708	1	1	1	1	1	1	6
NONE	OG0005709	3	0	0	1	1	1	6
NONE	OG0005710	1	1	1	1	1	1	6
NONE	OG0005711	1	1	1	1	1	1	6
NONE	OG0005712	1	1	1	1	1	1	6
NONE	OG0005713	1	1	1	1	1	1	6
NONE	OG0005714	1	1	1	1	1	1	6
NONE	OG0005715	1	1	1	1	1	1	6
NONE	OG0005716	3	0	1	2	0	0	6
NONE	OG0005717	1	0	1	2	1	1	6
NONE	OG0005718	1	1	1	1	1	1	6
NONE	OG0005719	1	1	2	1	0	1	6
NONE	OG0005720	1	1	1	1	1	1	6
NONE	OG0005721	1	1	1	1	1	1	6
NONE	OG0005722	1	1	1	1	1	1	6
NONE	OG0005723	1	1	1	1	1	1	6
NONE	OG0005724	1	1	1	1	1	1	6
NONE	OG0005725	1	1	1	1	1	1	6
NONE	OG0005726	1	1	1	1	1	1	6
NONE	OG0005727	1	1	1	1	1	1	6
NONE	OG0005728	1	1	1	1	1	1	6
NONE	OG0005729	1	1	1	1	1	1	6
NONE	OG0005730	1	1	1	1	1	1	6
NONE	OG0005731	1	1	1	1	1	1	6
NONE	OG0005732	1	1	1	1	1	1	6
NONE	OG0005733	1	1	1	1	1	1	6
NONE	OG0005734	1	1	1	1	1	1	6
NONE	OG0005735	1	1	1	1	1	1	6
NONE	OG0005736	1	1	1	1	1	1	6
NONE	OG0005737	1	1	1	1	1	1	6
NONE	OG0005738	1	1	1	1	1	1	6
NONE	OG0005739	1	1	1	1	1	1	6
NONE	OG0005740	1	1	1	1	1	1	6
NONE	OG0005741	1	0	1	2	1	1	6
NONE	OG0005742	1	1	1	2	0	1	6
NONE	OG0005743	2	0	1	1	1	1	6
NONE	OG0005744	1	1	1	1	1	1	6
NONE	OG0005745	1	1	1	1	1	1	6
NONE	OG0005746	1	1	1	1	1	1	6
NONE	OG0005747	1	1	1	1	1	1	6
NONE	OG0005748	1	1	1	1	1	1	6
NONE	OG0005749	2	1	1	1	1	0	6
NONE	OG0005750	1	1	1	1	1	1	6
NONE	OG0005751	1	1	1	1	1	1	6
NONE	OG0005752	1	1	1	1	1	1	6
NONE	OG0005753	1	1	1	1	1	1	6
NONE	OG0005754	1	1	1	1	1	1	6
NONE	OG0005755	1	1	1	1	1	1	6
NONE	OG0005756	1	1	1	1	1	1	6
NONE	OG0005757	1	0	2	1	1	1	6
NONE	OG0005758	1	1	1	1	1	1	6
NONE	OG0005759	1	1	1	1	1	1	6
NONE	OG0005760	1	1	1	1	1	1	6
NONE	OG0005761	1	0	1	1	2	1	6
NONE	OG0005762	1	0	2	1	1	1	6
NONE	OG0005763	1	1	1	1	1	1	6
NONE	OG0005764	1	1	1	1	1	1	6
NONE	OG0005765	1	1	1	1	1	1	6
NONE	OG0005766	1	1	1	1	1	1	6
NONE	OG0005767	1	1	1	1	1	1	6
NONE	OG0005768	1	1	1	1	1	1	6
NONE	OG0005769	1	0	1	1	1	2	6
NONE	OG0005770	1	1	1	1	1	1	6
NONE	OG0005771	1	1	1	1	1	1	6
NONE	OG0005772	1	2	1	0	1	1	6
NONE	OG0005773	1	1	1	1	1	1	6
NONE	OG0005774	1	1	1	1	1	1	6
NONE	OG0005775	1	1	1	1	1	1	6
NONE	OG0005776	1	1	1	1	1	1	6
NONE	OG0005777	1	1	1	1	1	1	6
NONE	OG0005778	1	1	1	1	1	1	6
NONE	OG0005779	1	1	1	1	1	1	6
NONE	OG0005780	1	1	1	1	1	1	6
NONE	OG0005781	1	1	1	1	1	1	6
NONE	OG0005782	1	1	1	1	1	1	6
NONE	OG0005783	1	1	1	1	1	1	6
NONE	OG0005784	1	1	1	1	1	1	6
NONE	OG0005785	1	1	1	1	1	1	6
NONE	OG0005786	1	1	1	1	1	1	6
NONE	OG0005787	1	1	1	1	1	1	6
NONE	OG0005788	1	1	1	1	1	1	6
NONE	OG0005789	1	1	1	1	1	1	6
NONE	OG0005790	1	1	1	1	1	1	6
NONE	OG0005791	1	1	1	1	1	1	6
NONE	OG0005792	1	1	1	1	1	1	6
NONE	OG0005793	1	1	1	1	1	1	6
NONE	OG0005794	1	1	1	1	1	1	6
NONE	OG0005795	1	1	1	1	1	1	6
NONE	OG0005796	2	1	1	1	0	1	6
NONE	OG0005797	1	1	1	1	1	1	6
NONE	OG0005798	1	1	1	1	1	1	6
NONE	OG0005799	1	1	1	1	1	1	6
NONE	OG0005800	1	1	1	1	1	1	6
NONE	OG0005801	1	0	1	2	1	1	6
NONE	OG0005802	1	1	1	1	1	1	6
NONE	OG0005803	1	1	1	1	1	1	6
NONE	OG0005804	1	1	1	1	1	1	6
NONE	OG0005805	1	1	1	1	2	0	6
NONE	OG0005806	1	0	1	1	2	1	6
NONE	OG0005807	1	0	1	2	1	1	6
NONE	OG0005808	1	1	1	1	1	1	6
NONE	OG0005809	3	0	1	0	0	2	6
NONE	OG0005810	1	1	1	1	1	1	6
NONE	OG0005811	3	0	1	0	0	2	6
NONE	OG0005812	1	0	1	0	0	4	6
NONE	OG0005813	1	0	3	0	0	2	6
NONE	OG0005814	1	1	1	1	1	1	6
NONE	OG0005815	1	1	1	1	1	1	6
NONE	OG0005816	1	1	1	1	1	1	6
NONE	OG0005817	1	1	1	1	1	1	6
NONE	OG0005818	1	1	1	1	1	1	6
NONE	OG0005819	1	1	1	2	1	0	6
NONE	OG0005820	1	1	1	1	1	1	6
NONE	OG0005821	1	1	1	1	1	1	6
NONE	OG0005822	1	1	1	1	1	1	6
NONE	OG0005823	1	1	1	1	1	1	6
NONE	OG0005824	1	1	1	1	1	1	6
NONE	OG0005825	1	1	1	1	1	1	6
NONE	OG0005826	1	1	1	1	0	2	6
NONE	OG0005827	1	1	1	1	1	1	6
NONE	OG0005828	1	1	1	1	1	1	6
NONE	OG0005829	1	1	1	1	1	1	6
NONE	OG0005830	1	1	1	1	1	1	6
NONE	OG0005831	1	1	1	1	1	1	6
NONE	OG0005832	1	1	1	1	1	1	6
NONE	OG0005833	1	1	1	1	1	1	6
NONE	OG0005834	1	1	1	1	1	1	6
NONE	OG0005835	1	1	1	1	1	1	6
NONE	OG0005836	1	1	1	1	1	1	6
NONE	OG0005837	1	1	1	1	1	1	6
NONE	OG0005838	1	1	1	1	1	1	6
NONE	OG0005839	1	1	1	1	1	1	6
NONE	OG0005840	1	1	1	1	1	1	6
NONE	OG0005841	1	1	1	1	1	1	6
NONE	OG0005842	1	0	1	2	1	1	6
NONE	OG0005843	1	1	1	1	1	1	6
NONE	OG0005844	1	1	1	1	1	1	6
NONE	OG0005845	1	1	1	1	1	1	6
NONE	OG0005846	1	1	1	1	1	1	6
NONE	OG0005847	1	1	1	1	1	1	6
NONE	OG0005848	1	1	1	1	1	1	6
NONE	OG0005849	1	1	1	1	1	1	6
NONE	OG0005850	1	1	1	1	1	1	6
NONE	OG0005851	1	0	1	2	1	1	6
NONE	OG0005852	1	1	1	1	1	1	6
NONE	OG0005853	1	1	1	1	1	1	6
NONE	OG0005854	1	1	1	1	1	1	6
NONE	OG0005855	1	1	1	1	1	1	6
NONE	OG0005856	1	1	1	1	1	1	6
NONE	OG0005857	1	1	1	1	1	1	6
NONE	OG0005858	1	1	1	1	1	1	6
NONE	OG0005859	1	1	1	1	1	1	6
NONE	OG0005860	1	1	1	1	1	1	6
NONE	OG0005861	1	1	1	1	1	1	6
NONE	OG0005862	1	1	1	1	1	1	6
NONE	OG0005863	1	1	1	1	1	1	6
NONE	OG0005864	1	1	1	1	1	1	6
NONE	OG0005865	1	1	1	1	1	1	6
NONE	OG0005866	1	1	1	1	1	1	6
NONE	OG0005867	1	1	1	1	2	0	6
NONE	OG0005868	1	1	1	1	1	1	6
NONE	OG0005869	1	1	1	1	1	1	6
NONE	OG0005870	1	1	1	1	1	1	6
NONE	OG0005871	1	1	1	1	1	1	6
NONE	OG0005872	1	1	1	1	1	1	6
NONE	OG0005873	1	1	1	1	1	1	6
NONE	OG0005874	1	1	1	1	1	1	6
NONE	OG0005875	1	1	1	1	1	1	6
NONE	OG0005876	1	1	1	1	1	1	6
NONE	OG0005877	1	1	1	1	1	1	6
NONE	OG0005878	1	1	1	1	1	1	6
NONE	OG0005879	1	1	1	1	1	1	6
NONE	OG0005880	1	1	1	1	1	1	6
NONE	OG0005881	1	1	1	1	1	1	6
NONE	OG0005882	1	1	1	1	1	1	6
NONE	OG0005883	1	1	1	1	1	1	6
NONE	OG0005884	1	1	1	1	1	1	6
NONE	OG0005885	1	1	1	1	1	1	6
NONE	OG0005886	1	1	1	1	1	1	6
NONE	OG0005887	1	1	1	1	1	1	6
NONE	OG0005888	1	1	1	1	1	1	6
NONE	OG0005889	1	1	1	1	1	1	6
NONE	OG0005890	1	1	1	1	1	1	6
NONE	OG0005891	1	1	1	1	1	1	6
NONE	OG0005892	1	1	1	1	1	1	6
NONE	OG0005893	1	1	1	1	1	1	6
NONE	OG0005894	1	1	1	1	1	1	6
NONE	OG0005895	1	1	1	1	1	1	6
NONE	OG0005896	1	1	1	1	1	1	6
NONE	OG0005897	1	1	1	1	1	1	6
NONE	OG0005898	1	1	1	1	1	1	6
NONE	OG0005899	1	2	1	1	0	1	6
NONE	OG0005900	1	1	2	0	1	1	6
NONE	OG0005901	1	1	1	1	1	1	6
NONE	OG0005902	1	1	1	1	1	1	6
NONE	OG0005903	1	1	1	1	1	1	6
NONE	OG0005904	1	1	1	1	1	1	6
NONE	OG0005905	1	1	1	1	1	1	6
NONE	OG0005906	1	1	1	1	1	1	6
NONE	OG0005907	1	1	1	1	1	1	6
NONE	OG0005908	1	1	1	1	1	1	6
NONE	OG0005909	1	1	1	1	1	1	6
NONE	OG0005910	1	1	1	1	1	1	6
NONE	OG0005911	1	1	1	1	1	1	6
NONE	OG0005912	1	1	1	1	1	1	6
NONE	OG0005913	1	1	1	1	1	1	6
NONE	OG0005914	1	1	1	1	1	1	6
NONE	OG0005915	1	1	1	1	1	1	6
NONE	OG0005916	1	1	1	1	1	1	6
NONE	OG0005917	1	1	1	1	1	1	6
NONE	OG0005918	1	1	1	1	1	1	6
NONE	OG0005919	2	1	1	1	0	1	6
NONE	OG0005920	2	1	1	0	1	1	6
NONE	OG0005921	2	1	1	0	1	1	6
NONE	OG0005922	1	1	1	1	1	1	6
NONE	OG0005923	1	1	1	1	1	1	6
NONE	OG0005924	2	0	1	1	1	1	6
NONE	OG0005925	1	1	1	1	1	1	6
NONE	OG0005926	1	1	1	1	1	1	6
NONE	OG0005927	1	1	1	1	1	1	6
NONE	OG0005928	1	0	1	3	0	1	6
NONE	OG0005929	1	1	1	1	1	1	6
NONE	OG0005930	2	0	1	1	1	1	6
NONE	OG0005931	2	0	1	1	1	1	6
NONE	OG0005932	1	1	1	1	1	1	6
NONE	OG0005933	1	1	1	1	1	1	6
NONE	OG0005934	1	1	1	1	1	1	6
NONE	OG0005935	2	0	1	1	1	1	6
NONE	OG0005936	1	1	1	1	1	1	6
NONE	OG0005937	1	1	1	1	1	1	6
NONE	OG0005938	1	1	1	1	1	1	6
NONE	OG0005939	1	1	1	1	1	1	6
NONE	OG0005940	1	1	1	1	1	1	6
NONE	OG0005941	1	1	1	1	1	1	6
NONE	OG0005942	1	1	1	1	1	1	6
NONE	OG0005943	2	0	4	0	0	0	6
NONE	OG0005944	1	1	2	1	0	1	6
NONE	OG0005945	1	0	3	1	0	1	6
NONE	OG0005946	1	1	2	1	0	1	6
NONE	OG0005947	1	1	1	1	1	1	6
NONE	OG0005948	1	1	1	1	1	1	6
NONE	OG0005949	1	1	1	1	1	1	6
NONE	OG0005950	1	1	1	1	1	1	6
NONE	OG0005951	1	1	1	1	1	1	6
NONE	OG0005952	1	1	1	1	1	1	6
NONE	OG0005953	1	1	1	1	1	1	6
NONE	OG0005954	1	1	1	1	1	1	6
NONE	OG0005955	1	1	1	1	1	1	6
NONE	OG0005956	1	1	1	1	1	1	6
NONE	OG0005957	1	1	1	1	1	1	6
NONE	OG0005958	1	1	1	1	1	1	6
NONE	OG0005959	1	1	1	1	1	1	6
NONE	OG0005960	1	0	1	2	1	1	6
NONE	OG0005961	1	1	1	1	1	1	6
NONE	OG0005962	1	1	1	1	1	1	6
NONE	OG0005963	1	1	1	1	1	1	6
NONE	OG0005964	1	1	1	1	1	1	6
NONE	OG0005965	1	1	1	1	1	1	6
NONE	OG0005966	1	1	1	1	1	1	6
NONE	OG0005967	1	1	1	1	1	1	6
NONE	OG0005968	1	1	1	1	1	1	6
NONE	OG0005969	1	0	1	2	1	1	6
NONE	OG0005970	1	1	1	1	1	1	6
NONE	OG0005971	1	1	1	1	1	1	6
NONE	OG0005972	1	1	1	1	1	1	6
NONE	OG0005973	1	1	1	1	1	1	6
NONE	OG0005974	1	1	1	1	1	1	6
NONE	OG0005975	1	1	1	1	1	1	6
NONE	OG0005976	1	1	2	1	0	1	6
NONE	OG0005977	1	0	1	1	1	2	6
NONE	OG0005978	1	1	1	1	1	1	6
NONE	OG0005979	1	1	1	1	1	1	6
NONE	OG0005980	1	1	1	1	1	1	6
NONE	OG0005981	1	1	1	1	1	1	6
NONE	OG0005982	1	1	1	1	1	1	6
NONE	OG0005983	1	1	1	1	1	1	6
NONE	OG0005984	1	1	1	1	1	1	6
NONE	OG0005985	1	1	1	1	1	1	6
NONE	OG0005986	1	1	1	1	1	1	6
NONE	OG0005987	1	1	1	1	1	1	6
NONE	OG0005988	1	1	1	1	1	1	6
NONE	OG0005989	1	1	1	1	1	1	6
NONE	OG0005990	1	1	1	1	1	1	6
NONE	OG0005991	1	1	1	1	1	1	6
NONE	OG0005992	1	1	1	1	1	1	6
NONE	OG0005993	1	1	1	1	1	1	6
NONE	OG0005994	1	1	1	1	1	1	6
NONE	OG0005995	1	1	1	1	1	1	6
NONE	OG0005996	1	1	1	1	1	1	6
NONE	OG0005997	1	1	1	1	1	1	6
NONE	OG0005998	1	1	1	1	1	1	6
NONE	OG0005999	1	1	1	1	1	1	6
NONE	OG0006000	1	1	1	1	1	1	6
NONE	OG0006001	1	1	1	1	1	1	6
NONE	OG0006002	1	1	1	1	1	1	6
NONE	OG0006003	1	1	1	1	1	1	6
NONE	OG0006004	1	1	1	1	1	1	6
NONE	OG0006005	1	1	1	1	1	1	6
NONE	OG0006006	1	1	1	1	1	1	6
NONE	OG0006007	1	1	1	1	1	1	6
NONE	OG0006008	1	1	1	1	1	1	6
NONE	OG0006009	1	1	1	1	1	1	6
NONE	OG0006010	1	1	1	1	1	1	6
NONE	OG0006011	2	0	1	1	1	1	6
NONE	OG0006012	1	1	1	1	1	1	6
NONE	OG0006013	1	1	1	1	1	1	6
NONE	OG0006014	1	1	1	1	1	1	6
NONE	OG0006015	1	1	1	1	1	1	6
NONE	OG0006016	1	1	1	1	1	1	6
NONE	OG0006017	1	1	1	1	1	1	6
NONE	OG0006018	1	1	1	1	1	1	6
NONE	OG0006019	1	2	1	1	0	1	6
NONE	OG0006020	1	1	1	1	1	1	6
NONE	OG0006021	1	1	1	1	1	1	6
NONE	OG0006022	1	0	2	1	1	1	6
NONE	OG0006023	1	1	1	1	1	1	6
NONE	OG0006024	1	1	1	1	1	1	6
NONE	OG0006025	1	1	1	1	1	1	6
NONE	OG0006026	1	1	2	1	0	1	6
NONE	OG0006027	1	1	1	1	1	1	6
NONE	OG0006028	1	1	1	1	1	1	6
NONE	OG0006029	1	1	1	1	1	1	6
NONE	OG0006030	1	1	1	1	1	1	6
NONE	OG0006031	1	1	1	1	1	1	6
NONE	OG0006032	1	1	1	1	1	1	6
NONE	OG0006033	1	1	1	1	1	1	6
NONE	OG0006034	1	1	1	1	1	1	6
NONE	OG0006035	1	1	1	1	1	1	6
NONE	OG0006036	1	1	1	1	1	1	6
NONE	OG0006037	1	1	1	1	1	1	6
NONE	OG0006038	2	1	1	1	0	1	6
NONE	OG0006039	1	1	1	1	1	1	6
NONE	OG0006040	1	1	1	1	1	1	6
NONE	OG0006041	1	1	1	1	1	1	6
NONE	OG0006042	2	0	1	1	1	1	6
NONE	OG0006043	1	1	1	1	1	1	6
NONE	OG0006044	1	1	1	1	1	1	6
NONE	OG0006045	1	0	2	1	1	1	6
NONE	OG0006046	6	0	0	0	0	0	6
NONE	OG0006047	1	1	1	1	1	1	6
NONE	OG0006048	1	1	1	1	1	1	6
NONE	OG0006049	1	1	1	1	1	1	6
NONE	OG0006050	1	1	1	1	1	1	6
NONE	OG0006051	1	1	1	2	0	1	6
NONE	OG0006052	1	0	3	1	0	1	6
NONE	OG0006053	1	1	1	1	1	1	6
NONE	OG0006054	1	1	1	1	1	1	6
NONE	OG0006055	1	1	1	1	1	1	6
NONE	OG0006056	1	1	1	1	1	1	6
NONE	OG0006057	1	1	1	1	1	1	6
NONE	OG0006058	1	1	1	1	1	1	6
NONE	OG0006059	1	1	1	1	1	1	6
NONE	OG0006060	1	1	1	1	1	1	6
NONE	OG0006061	1	1	1	1	1	1	6
NONE	OG0006062	1	1	1	1	1	1	6
NONE	OG0006063	1	1	1	1	1	1	6
NONE	OG0006064	1	1	1	1	1	1	6
NONE	OG0006065	1	1	1	1	1	1	6
NONE	OG0006066	1	0	1	1	2	1	6
NONE	OG0006067	1	1	1	1	1	1	6
NONE	OG0006068	1	1	1	1	1	1	6
NONE	OG0006069	1	1	1	1	1	1	6
NONE	OG0006070	2	1	1	1	0	1	6
NONE	OG0006071	1	0	3	1	1	0	6
NONE	OG0006072	1	1	1	1	1	1	6
NONE	OG0006073	1	1	1	1	1	1	6
NONE	OG0006074	2	0	2	1	0	1	6
NONE	OG0006075	1	1	1	1	1	1	6
NONE	OG0006076	1	1	1	1	1	1	6
NONE	OG0006077	1	1	1	1	1	1	6
NONE	OG0006078	1	1	1	1	0	2	6
NONE	OG0006079	1	0	1	0	0	4	6
NONE	OG0006080	1	1	1	1	1	1	6
NONE	OG0006081	1	1	1	1	1	1	6
NONE	OG0006082	1	1	1	1	1	1	6
NONE	OG0006083	1	1	1	1	1	1	6
NONE	OG0006084	1	1	1	1	1	1	6
NONE	OG0006085	1	1	2	1	0	1	6
NONE	OG0006086	1	1	1	1	1	1	6
NONE	OG0006087	1	1	1	1	1	1	6
NONE	OG0006088	1	1	1	1	1	1	6
NONE	OG0006089	1	1	1	1	1	1	6
NONE	OG0006090	1	1	1	1	1	1	6
NONE	OG0006091	1	1	1	1	1	1	6
NONE	OG0006092	1	1	1	1	1	1	6
NONE	OG0006093	1	1	1	1	1	1	6
NONE	OG0006094	1	1	1	1	1	1	6
NONE	OG0006095	1	1	1	1	1	1	6
NONE	OG0006096	1	1	1	1	1	1	6
NONE	OG0006097	2	0	3	1	0	0	6
NONE	OG0006098	1	1	1	1	1	1	6
NONE	OG0006099	1	1	1	1	1	1	6
NONE	OG0006100	2	1	1	1	0	1	6
NONE	OG0006101	1	1	1	1	1	1	6
NONE	OG0006102	1	1	1	1	1	1	6
NONE	OG0006103	1	1	1	1	1	1	6
NONE	OG0006104	2	0	1	1	1	1	6
NONE	OG0006105	2	0	1	1	1	1	6
NONE	OG0006106	1	1	1	1	1	1	6
NONE	OG0006107	1	1	1	1	1	1	6
NONE	OG0006108	1	1	1	1	1	1	6
NONE	OG0006109	1	1	1	1	1	1	6
NONE	OG0006110	1	1	1	1	1	1	6
NONE	OG0006111	1	1	1	1	1	1	6
NONE	OG0006112	1	1	1	1	1	1	6
NONE	OG0006113	1	1	1	1	1	1	6
NONE	OG0006114	1	1	1	1	1	1	6
NONE	OG0006115	2	1	1	0	1	1	6
NONE	OG0006116	2	1	1	1	0	1	6
NONE	OG0006117	1	1	1	1	1	1	6
NONE	OG0006118	1	1	1	1	1	1	6
NONE	OG0006119	2	1	1	0	1	1	6
NONE	OG0006120	1	1	1	1	1	1	6
NONE	OG0006121	1	1	1	1	1	1	6
NONE	OG0006122	1	1	1	1	1	1	6
NONE	OG0006123	1	1	1	1	1	1	6
NONE	OG0006124	1	1	1	1	1	1	6
NONE	OG0006125	1	1	1	1	1	1	6
NONE	OG0006126	1	1	1	1	1	1	6
NONE	OG0006127	1	1	1	1	1	1	6
NONE	OG0006128	1	1	1	1	1	1	6
NONE	OG0006129	1	1	1	1	1	1	6
NONE	OG0006130	1	1	1	1	1	1	6
NONE	OG0006131	2	0	1	1	1	1	6
NONE	OG0006132	2	0	1	1	1	1	6
NONE	OG0006133	1	1	1	1	0	2	6
NONE	OG0006134	1	1	1	1	1	1	6
NONE	OG0006135	2	0	1	1	1	1	6
NONE	OG0006136	1	1	1	1	1	1	6
NONE	OG0006137	1	1	1	1	1	1	6
NONE	OG0006138	1	1	1	1	1	1	6
NONE	OG0006139	1	1	1	1	1	1	6
NONE	OG0006140	1	1	1	1	1	1	6
NONE	OG0006141	4	0	0	0	2	0	6
NONE	OG0006142	1	0	3	1	1	0	6
NONE	OG0006143	1	0	2	1	1	1	6
NONE	OG0006144	1	1	1	1	1	1	6
NONE	OG0006145	1	1	1	1	1	1	6
NONE	OG0006146	1	1	1	1	1	1	6
NONE	OG0006147	1	1	1	1	1	1	6
NONE	OG0006148	1	1	1	2	0	1	6
NONE	OG0006149	1	1	1	1	1	1	6
NONE	OG0006150	1	1	1	1	1	1	6
NONE	OG0006151	1	1	1	1	1	1	6
NONE	OG0006152	1	1	1	1	1	1	6
NONE	OG0006153	1	0	1	2	0	2	6
NONE	OG0006154	1	0	1	2	1	1	6
NONE	OG0006155	1	1	1	2	0	1	6
NONE	OG0006156	1	1	1	1	1	1	6
NONE	OG0006157	1	1	1	1	1	1	6
NONE	OG0006158	1	1	1	1	1	1	6
NONE	OG0006159	1	1	1	1	1	1	6
NONE	OG0006160	1	1	1	1	1	1	6
NONE	OG0006161	1	1	1	1	1	1	6
NONE	OG0006162	1	1	1	1	1	1	6
NONE	OG0006163	1	1	1	1	1	1	6
NONE	OG0006164	1	1	1	1	1	1	6
NONE	OG0006165	1	1	1	1	1	1	6
NONE	OG0006166	1	1	1	1	1	1	6
NONE	OG0006167	1	1	1	1	1	1	6
NONE	OG0006168	1	1	1	1	1	1	6
NONE	OG0006169	1	1	1	1	1	1	6
NONE	OG0006170	1	1	1	1	1	1	6
NONE	OG0006171	1	1	1	1	1	1	6
NONE	OG0006172	1	1	1	1	1	1	6
NONE	OG0006173	1	1	1	1	1	1	6
NONE	OG0006174	1	1	1	1	1	1	6
NONE	OG0006175	1	1	1	1	1	1	6
NONE	OG0006176	1	1	1	1	1	1	6
NONE	OG0006177	1	1	1	1	1	1	6
NONE	OG0006178	1	1	1	1	1	1	6
NONE	OG0006179	1	1	1	1	1	1	6
NONE	OG0006180	1	1	1	1	1	1	6
NONE	OG0006181	1	1	2	0	1	1	6
NONE	OG0006182	1	1	1	1	1	1	6
NONE	OG0006183	1	1	1	1	1	1	6
NONE	OG0006184	1	1	1	1	1	1	6
NONE	OG0006185	1	1	1	1	1	1	6
NONE	OG0006186	1	1	1	1	1	1	6
NONE	OG0006187	2	1	1	1	0	1	6
NONE	OG0006188	1	1	1	1	1	1	6
NONE	OG0006189	1	1	1	1	1	1	6
NONE	OG0006190	1	1	1	1	1	1	6
NONE	OG0006191	1	1	1	1	1	1	6
NONE	OG0006192	1	1	1	1	1	1	6
NONE	OG0006193	1	1	1	1	1	1	6
NONE	OG0006194	1	1	1	1	1	1	6
NONE	OG0006195	1	1	1	1	1	1	6
NONE	OG0006196	1	1	1	1	1	1	6
NONE	OG0006197	1	1	1	2	0	1	6
NONE	OG0006198	1	1	1	1	1	1	6
NONE	OG0006199	1	1	1	1	1	1	6
NONE	OG0006200	1	1	1	1	1	1	6
NONE	OG0006201	1	1	1	1	1	1	6
NONE	OG0006202	2	0	2	1	0	1	6
NONE	OG0006203	1	1	1	1	1	1	6
NONE	OG0006204	1	1	1	1	1	1	6
NONE	OG0006205	1	1	1	1	1	1	6
NONE	OG0006206	1	1	1	1	1	1	6
NONE	OG0006207	1	1	1	1	1	1	6
NONE	OG0006208	1	1	1	1	1	1	6
NONE	OG0006209	1	1	1	1	1	1	6
NONE	OG0006210	1	1	1	1	1	1	6
NONE	OG0006211	1	1	1	1	1	1	6
NONE	OG0006212	1	1	1	1	1	1	6
NONE	OG0006213	1	1	1	1	1	1	6
NONE	OG0006214	1	1	1	1	1	1	6
NONE	OG0006215	1	1	1	1	1	1	6
NONE	OG0006216	1	1	1	1	1	1	6
NONE	OG0006217	1	1	1	1	1	1	6
NONE	OG0006218	1	0	2	1	1	1	6
NONE	OG0006219	1	1	1	1	1	1	6
NONE	OG0006220	1	1	1	1	1	1	6
NONE	OG0006221	1	1	1	1	1	1	6
NONE	OG0006222	1	1	1	1	1	1	6
NONE	OG0006223	1	1	1	2	0	1	6
NONE	OG0006224	1	1	1	1	1	1	6
NONE	OG0006225	1	0	2	1	1	1	6
NONE	OG0006226	2	0	2	0	0	2	6
NONE	OG0006227	1	1	1	1	1	1	6
NONE	OG0006228	1	1	1	1	1	1	6
NONE	OG0006229	1	1	1	1	1	1	6
NONE	OG0006230	1	1	2	0	1	1	6
NONE	OG0006231	1	1	2	0	1	1	6
NONE	OG0006232	1	1	2	0	1	1	6
NONE	OG0006233	1	0	3	0	1	1	6
NONE	OG0006234	1	1	2	1	0	1	6
NONE	OG0006235	1	1	1	1	1	1	6
NONE	OG0006236	1	1	1	1	0	2	6
NONE	OG0006237	1	1	1	2	0	1	6
NONE	OG0006238	1	1	1	1	1	1	6
NONE	OG0006239	1	1	1	1	1	1	6
NONE	OG0006240	1	1	1	1	1	1	6
NONE	OG0006241	1	1	1	1	1	1	6
NONE	OG0006242	1	1	1	1	1	1	6
NONE	OG0006243	1	1	1	1	1	1	6
NONE	OG0006244	1	1	1	1	1	1	6
NONE	OG0006245	1	1	1	1	1	1	6
NONE	OG0006246	1	1	1	1	1	1	6
NONE	OG0006247	1	1	1	1	1	1	6
NONE	OG0006248	1	1	1	1	1	1	6
NONE	OG0006249	1	1	1	1	1	1	6
NONE	OG0006250	1	1	1	1	1	1	6
NONE	OG0006251	1	1	1	1	1	1	6
NONE	OG0006252	1	1	1	1	1	1	6
NONE	OG0006253	1	1	1	1	1	1	6
NONE	OG0006254	1	1	1	1	1	1	6
NONE	OG0006255	1	1	1	1	1	1	6
NONE	OG0006256	1	1	1	1	1	1	6
NONE	OG0006257	2	0	1	1	1	1	6
NONE	OG0006258	1	1	1	1	1	1	6
NONE	OG0006259	1	1	1	1	1	1	6
NONE	OG0006260	1	1	1	1	1	1	6
NONE	OG0006261	1	1	1	1	1	1	6
NONE	OG0006262	1	1	1	1	1	1	6
NONE	OG0006263	1	1	1	1	1	1	6
NONE	OG0006264	1	1	1	1	1	1	6
NONE	OG0006265	1	1	1	1	1	1	6
NONE	OG0006266	1	1	1	1	1	1	6
NONE	OG0006267	1	0	1	2	1	1	6
NONE	OG0006268	1	1	1	1	1	1	6
NONE	OG0006269	1	1	1	1	1	1	6
NONE	OG0006270	1	0	1	1	0	3	6
NONE	OG0006271	1	1	1	1	1	1	6
NONE	OG0006272	2	1	1	2	0	0	6
NONE	OG0006273	1	0	1	2	0	2	6
NONE	OG0006274	1	1	1	1	1	1	6
NONE	OG0006275	1	0	1	2	1	1	6
NONE	OG0006276	1	1	1	2	0	1	6
NONE	OG0006277	1	0	1	2	1	1	6
NONE	OG0006278	1	1	0	2	1	1	6
NONE	OG0006279	1	0	1	2	1	1	6
NONE	OG0006280	2	1	1	1	0	1	6
NONE	OG0006281	1	1	1	1	1	1	6
NONE	OG0006282	1	1	1	1	1	1	6
NONE	OG0006283	1	1	1	1	1	1	6
NONE	OG0006284	1	1	1	1	1	1	6
NONE	OG0006285	1	1	1	1	1	1	6
NONE	OG0006286	1	1	1	1	1	1	6
NONE	OG0006287	1	1	1	1	1	1	6
NONE	OG0006288	1	1	1	1	1	1	6
NONE	OG0006289	1	1	1	1	1	1	6
NONE	OG0006290	1	1	1	1	1	1	6
NONE	OG0006291	1	1	1	1	1	1	6
NONE	OG0006292	1	1	1	1	1	1	6
NONE	OG0006293	1	1	1	1	1	1	6
NONE	OG0006294	1	1	1	1	1	1	6
NONE	OG0006295	2	1	2	0	0	1	6
NONE	OG0006296	1	0	1	3	0	1	6
NONE	OG0006297	1	1	1	1	1	1	6
NONE	OG0006298	1	1	1	1	1	1	6
NONE	OG0006299	1	1	1	1	1	1	6
NONE	OG0006300	1	1	1	1	1	1	6
NONE	OG0006301	1	1	1	1	1	1	6
NONE	OG0006302	1	1	1	1	1	1	6
NONE	OG0006303	1	1	1	1	1	1	6
NONE	OG0006304	1	1	1	1	1	1	6
NONE	OG0006305	1	1	1	1	1	1	6
NONE	OG0006306	1	1	1	1	1	1	6
NONE	OG0006307	1	1	1	1	1	1	6
NONE	OG0006308	1	1	1	1	1	1	6
NONE	OG0006309	1	1	1	1	1	1	6
NONE	OG0006310	1	1	1	1	1	1	6
NONE	OG0006311	1	1	1	1	1	1	6
NONE	OG0006312	1	1	1	1	1	1	6
NONE	OG0006313	1	1	1	1	1	1	6
NONE	OG0006314	1	1	1	1	1	1	6
NONE	OG0006315	1	1	1	1	1	1	6
NONE	OG0006316	1	1	1	1	1	1	6
NONE	OG0006317	1	1	1	1	1	1	6
NONE	OG0006318	1	1	1	1	1	1	6
NONE	OG0006319	1	1	1	1	1	1	6
NONE	OG0006320	1	1	1	1	1	1	6
NONE	OG0006321	1	1	1	1	1	1	6
NONE	OG0006322	1	1	1	1	1	1	6
NONE	OG0006323	1	1	1	1	1	1	6
NONE	OG0006324	1	1	1	1	1	1	6
NONE	OG0006325	1	1	1	1	1	1	6
NONE	OG0006326	1	1	1	1	1	1	6
NONE	OG0006327	1	1	1	1	1	1	6
NONE	OG0006328	1	1	1	1	1	1	6
NONE	OG0006329	1	0	2	2	0	1	6
NONE	OG0006330	1	1	1	1	1	1	6
NONE	OG0006331	1	1	1	1	1	1	6
NONE	OG0006332	1	1	1	1	1	1	6
NONE	OG0006333	1	1	1	1	1	1	6
NONE	OG0006334	1	1	1	1	1	1	6
NONE	OG0006335	1	1	1	1	1	1	6
NONE	OG0006336	1	1	1	1	1	1	6
NONE	OG0006337	1	0	1	2	0	2	6
NONE	OG0006338	1	1	1	1	1	1	6
NONE	OG0006339	1	1	1	1	1	1	6
NONE	OG0006340	6	0	0	0	0	0	6
NONE	OG0006341	5	0	0	1	0	0	6
NONE	OG0006342	6	0	0	0	0	0	6
NONE	OG0006343	1	1	1	1	1	1	6
NONE	OG0006344	1	1	1	1	1	1	6
NONE	OG0006345	1	1	1	1	1	1	6
NONE	OG0006346	1	1	1	1	1	1	6
NONE	OG0006347	1	1	1	1	1	1	6
NONE	OG0006348	1	1	1	1	1	1	6
NONE	OG0006349	1	1	1	1	1	1	6
NONE	OG0006350	1	1	1	1	1	1	6
NONE	OG0006351	1	1	1	1	1	1	6
NONE	OG0006352	1	1	1	1	1	1	6
NONE	OG0006353	1	1	1	1	1	1	6
NONE	OG0006354	1	1	1	1	1	1	6
NONE	OG0006355	2	1	1	0	1	1	6
NONE	OG0006356	1	1	1	1	1	1	6
NONE	OG0006357	1	1	1	1	1	1	6
NONE	OG0006358	1	1	1	1	1	1	6
NONE	OG0006359	1	1	1	1	1	1	6
NONE	OG0006360	1	1	1	1	1	1	6
NONE	OG0006361	1	1	1	1	1	1	6
NONE	OG0006362	1	1	1	1	1	1	6
NONE	OG0006363	3	0	3	0	0	0	6
NONE	OG0006364	1	1	1	1	1	1	6
NONE	OG0006365	1	1	1	1	1	1	6
NONE	OG0006366	1	1	1	1	1	1	6
NONE	OG0006367	1	1	1	1	1	1	6
NONE	OG0006368	1	1	1	1	1	1	6
NONE	OG0006369	1	1	1	1	1	1	6
NONE	OG0006370	1	1	1	1	1	1	6
NONE	OG0006371	1	1	1	1	1	1	6
NONE	OG0006372	1	1	1	1	1	1	6
NONE	OG0006373	1	1	2	1	0	1	6
NONE	OG0006374	1	1	1	1	1	1	6
NONE	OG0006375	1	1	1	1	1	1	6
NONE	OG0006376	1	1	1	1	1	1	6
NONE	OG0006377	1	1	1	1	1	1	6
NONE	OG0006378	1	1	1	1	1	1	6
NONE	OG0006379	1	1	1	1	1	1	6
NONE	OG0006380	1	1	1	1	1	1	6
NONE	OG0006381	1	1	1	1	1	1	6
NONE	OG0006382	1	1	1	1	1	1	6
NONE	OG0006383	1	1	1	1	1	1	6
NONE	OG0006384	1	1	1	1	1	1	6
NONE	OG0006385	2	1	1	1	0	1	6
NONE	OG0006386	1	1	1	1	1	1	6
NONE	OG0006387	1	1	1	1	1	1	6
NONE	OG0006388	1	1	1	1	1	1	6
NONE	OG0006389	1	1	1	1	1	1	6
NONE	OG0006390	1	1	1	1	1	1	6
NONE	OG0006391	1	1	1	1	1	1	6
NONE	OG0006392	2	0	1	1	1	1	6
NONE	OG0006393	1	1	1	1	1	1	6
NONE	OG0006394	1	1	1	1	1	1	6
NONE	OG0006395	1	1	1	1	1	1	6
NONE	OG0006396	1	1	1	1	1	1	6
NONE	OG0006397	1	1	1	1	1	1	6
NONE	OG0006398	1	1	1	1	1	1	6
NONE	OG0006399	1	1	1	1	1	1	6
NONE	OG0006400	1	1	1	1	1	1	6
NONE	OG0006401	1	1	1	1	1	1	6
NONE	OG0006402	1	1	1	1	1	1	6
NONE	OG0006403	1	1	1	1	1	1	6
NONE	OG0006404	1	1	1	1	1	1	6
NONE	OG0006405	1	1	1	1	1	1	6
NONE	OG0006406	1	1	1	1	1	1	6
NONE	OG0006407	1	1	2	1	0	1	6
NONE	OG0006408	1	0	1	3	0	1	6
NONE	OG0006409	1	1	1	1	1	1	6
NONE	OG0006410	1	1	1	1	1	1	6
NONE	OG0006411	1	1	1	1	1	1	6
NONE	OG0006412	1	1	1	1	1	1	6
NONE	OG0006413	1	1	1	1	1	1	6
NONE	OG0006414	1	1	1	1	1	1	6
NONE	OG0006415	1	1	1	1	1	1	6
NONE	OG0006416	1	1	1	1	1	1	6
NONE	OG0006417	1	1	1	1	1	1	6
NONE	OG0006418	1	1	1	1	1	1	6
NONE	OG0006419	2	0	1	0	1	2	6
NONE	OG0006420	1	1	1	1	1	1	6
NONE	OG0006421	1	1	1	1	1	1	6
NONE	OG0006422	1	1	1	1	1	1	6
NONE	OG0006423	1	1	1	1	1	1	6
NONE	OG0006424	1	1	1	1	1	1	6
NONE	OG0006425	1	1	1	1	1	1	6
NONE	OG0006426	1	0	1	2	1	1	6
NONE	OG0006427	1	0	1	1	2	1	6
NONE	OG0006428	1	1	1	1	1	1	6
NONE	OG0006429	1	1	1	1	1	1	6
NONE	OG0006430	1	1	1	1	1	1	6
NONE	OG0006431	1	1	1	1	1	1	6
NONE	OG0006432	2	0	1	1	1	1	6
NONE	OG0006433	1	1	1	1	1	1	6
NONE	OG0006434	1	1	1	1	1	1	6
NONE	OG0006435	1	1	1	1	1	1	6
NONE	OG0006436	1	1	1	1	1	1	6
NONE	OG0006437	1	1	1	1	1	1	6
NONE	OG0006438	1	1	1	1	1	1	6
NONE	OG0006439	1	0	1	2	1	1	6
NONE	OG0006440	1	1	1	1	1	1	6
NONE	OG0006441	1	1	1	1	1	1	6
NONE	OG0006442	1	1	1	1	1	1	6
NONE	OG0006443	1	1	1	1	1	1	6
NONE	OG0006444	1	0	1	1	1	2	6
NONE	OG0006445	1	1	1	1	1	1	6
NONE	OG0006446	1	1	1	1	1	1	6
NONE	OG0006447	1	1	1	1	1	1	6
NONE	OG0006448	1	1	1	1	1	1	6
NONE	OG0006449	1	1	1	1	1	1	6
NONE	OG0006450	1	1	1	1	1	1	6
NONE	OG0006451	2	0	1	1	1	1	6
NONE	OG0006452	2	0	1	1	1	1	6
NONE	OG0006453	1	1	1	1	1	1	6
NONE	OG0006454	1	1	1	1	1	1	6
NONE	OG0006455	1	1	1	1	1	1	6
NONE	OG0006456	1	1	1	1	1	1	6
NONE	OG0006457	2	0	1	1	1	1	6
NONE	OG0006458	1	1	1	1	1	1	6
NONE	OG0006459	1	1	1	1	1	1	6
NONE	OG0006460	1	0	2	2	0	1	6
NONE	OG0006461	1	1	1	1	1	1	6
NONE	OG0006462	1	1	1	1	1	1	6
NONE	OG0006463	1	1	1	1	1	1	6
NONE	OG0006464	1	1	1	1	1	1	6
NONE	OG0006465	1	1	1	1	1	1	6
NONE	OG0006466	1	1	1	1	1	1	6
NONE	OG0006467	1	1	1	1	1	1	6
NONE	OG0006468	1	1	1	1	1	1	6
NONE	OG0006469	1	1	1	1	1	1	6
NONE	OG0006470	1	0	0	5	0	0	6
NONE	OG0006471	1	1	1	1	1	1	6
NONE	OG0006472	1	1	1	1	1	1	6
NONE	OG0006473	1	1	1	1	1	1	6
NONE	OG0006474	1	1	1	1	1	1	6
NONE	OG0006475	1	1	1	1	1	1	6
NONE	OG0006476	1	1	1	1	1	1	6
NONE	OG0006477	1	1	1	1	1	1	6
NONE	OG0006478	1	1	1	1	1	1	6
NONE	OG0006479	1	1	1	1	1	1	6
NONE	OG0006480	1	1	1	1	1	1	6
NONE	OG0006481	1	1	1	1	1	1	6
NONE	OG0006482	1	1	1	1	1	1	6
NONE	OG0006483	1	1	1	1	1	1	6
NONE	OG0006484	1	1	1	1	1	1	6
NONE	OG0006485	1	1	1	1	1	1	6
NONE	OG0006486	1	1	1	1	1	1	6
NONE	OG0006487	2	0	1	2	0	1	6
NONE	OG0006488	1	1	1	1	1	1	6
NONE	OG0006489	1	1	1	1	1	1	6
NONE	OG0006490	1	1	1	1	1	1	6
NONE	OG0006491	1	1	1	1	1	1	6
NONE	OG0006492	1	1	1	1	1	1	6
NONE	OG0006493	1	1	1	1	1	1	6
NONE	OG0006494	1	1	1	1	1	1	6
NONE	OG0006495	1	1	1	1	1	1	6
NONE	OG0006496	1	1	1	1	1	1	6
NONE	OG0006497	1	1	1	1	1	1	6
NONE	OG0006498	1	1	1	1	1	1	6
NONE	OG0006499	1	1	1	1	1	1	6
NONE	OG0006500	1	1	1	1	1	1	6
NONE	OG0006501	1	1	1	1	1	1	6
NONE	OG0006502	1	1	1	1	1	1	6
NONE	OG0006503	1	1	1	1	1	1	6
NONE	OG0006504	1	1	1	1	1	1	6
NONE	OG0006505	1	1	1	1	1	1	6
NONE	OG0006506	1	1	1	1	1	1	6
NONE	OG0006507	1	1	1	1	1	1	6
NONE	OG0006508	1	1	1	2	0	1	6
NONE	OG0006509	1	1	1	1	1	1	6
NONE	OG0006510	4	0	2	0	0	0	6
NONE	OG0006511	1	1	1	1	1	1	6
NONE	OG0006512	1	0	3	1	0	1	6
NONE	OG0006513	1	1	1	1	1	1	6
NONE	OG0006514	1	1	1	1	1	1	6
NONE	OG0006515	1	1	1	1	1	1	6
NONE	OG0006516	1	1	1	1	1	1	6
NONE	OG0006517	1	1	1	1	1	1	6
NONE	OG0006518	1	1	1	1	1	1	6
NONE	OG0006519	1	1	1	1	1	1	6
NONE	OG0006520	1	1	1	1	1	1	6
NONE	OG0006521	1	1	1	1	1	1	6
NONE	OG0006522	1	1	1	1	1	1	6
NONE	OG0006523	1	1	1	1	1	1	6
NONE	OG0006524	1	1	1	1	1	1	6
NONE	OG0006525	1	1	1	1	1	1	6
NONE	OG0006526	1	1	1	1	1	1	6
NONE	OG0006527	1	1	1	1	1	1	6
NONE	OG0006528	1	1	1	1	1	1	6
NONE	OG0006529	1	1	1	1	1	1	6
NONE	OG0006530	1	1	1	1	1	1	6
NONE	OG0006531	1	1	1	1	1	1	6
NONE	OG0006532	1	1	1	1	1	1	6
NONE	OG0006533	1	1	1	1	1	1	6
NONE	OG0006534	1	1	1	1	1	1	6
NONE	OG0006535	1	1	1	1	1	1	6
NONE	OG0006536	1	1	1	1	1	1	6
NONE	OG0006537	1	0	1	2	1	1	6
NONE	OG0006538	1	0	1	2	1	1	6
NONE	OG0006539	1	0	1	3	0	1	6
NONE	OG0006540	1	1	1	1	1	1	6
NONE	OG0006541	1	1	1	1	1	1	6
NONE	OG0006542	1	1	1	1	1	1	6
NONE	OG0006543	1	1	1	1	1	1	6
NONE	OG0006544	1	1	1	1	1	1	6
NONE	OG0006545	2	0	2	0	0	2	6
NONE	OG0006546	1	1	1	1	1	1	6
NONE	OG0006547	1	1	1	1	1	1	6
NONE	OG0006548	1	1	1	1	1	1	6
NONE	OG0006549	2	0	0	0	0	4	6
NONE	OG0006550	1	1	1	1	1	1	6
NONE	OG0006551	1	1	1	1	1	1	6
NONE	OG0006552	1	1	1	1	1	1	6
NONE	OG0006553	1	1	1	1	1	1	6
NONE	OG0006554	1	1	1	1	1	1	6
NONE	OG0006555	1	1	1	1	1	1	6
NONE	OG0006556	1	1	1	1	1	1	6
NONE	OG0006557	1	1	1	1	1	1	6
NONE	OG0006558	1	1	1	1	1	1	6
NONE	OG0006559	1	1	1	1	1	1	6
NONE	OG0006560	1	1	1	1	1	1	6
NONE	OG0006561	1	1	1	1	1	1	6
NONE	OG0006562	1	1	1	1	1	1	6
NONE	OG0006563	1	1	1	1	1	1	6
NONE	OG0006564	1	1	1	1	1	1	6
NONE	OG0006565	1	1	1	1	1	1	6
NONE	OG0006566	1	1	1	1	1	1	6
NONE	OG0006567	1	1	1	1	1	1	6
NONE	OG0006568	1	1	1	1	1	1	6
NONE	OG0006569	1	1	1	1	1	1	6
NONE	OG0006570	1	1	1	1	1	1	6
NONE	OG0006571	1	1	1	1	1	1	6
NONE	OG0006572	1	1	1	1	1	1	6
NONE	OG0006573	1	1	1	1	1	1	6
NONE	OG0006574	1	1	1	1	1	1	6
NONE	OG0006575	1	1	1	1	1	1	6
NONE	OG0006576	1	1	1	1	1	1	6
NONE	OG0006577	1	1	1	1	1	1	6
NONE	OG0006578	1	1	1	1	1	1	6
NONE	OG0006579	1	1	1	1	1	1	6
NONE	OG0006580	1	1	1	1	1	1	6
NONE	OG0006581	1	1	1	1	1	1	6
NONE	OG0006582	1	1	1	1	1	1	6
NONE	OG0006583	1	1	1	1	1	1	6
NONE	OG0006584	1	1	1	1	1	1	6
NONE	OG0006585	1	1	1	1	1	1	6
NONE	OG0006586	1	1	1	1	1	1	6
NONE	OG0006587	1	0	2	3	0	0	6
NONE	OG0006588	1	1	1	1	2	0	6
NONE	OG0006589	1	1	1	1	1	1	6
NONE	OG0006590	1	1	1	1	1	1	6
NONE	OG0006591	1	1	1	1	1	1	6
NONE	OG0006592	1	1	1	1	1	1	6
NONE	OG0006593	1	1	1	1	1	1	6
NONE	OG0006594	1	1	1	1	1	1	6
NONE	OG0006595	1	1	1	1	1	1	6
NONE	OG0006596	1	1	1	1	1	1	6
NONE	OG0006597	1	1	2	1	0	1	6
NONE	OG0006598	3	0	2	1	0	0	6
NONE	OG0006599	1	0	2	1	1	1	6
NONE	OG0006600	1	0	2	1	1	1	6
NONE	OG0006601	1	1	1	1	1	1	6
NONE	OG0006602	1	1	1	1	1	1	6
NONE	OG0006603	1	1	1	1	1	1	6
NONE	OG0006604	1	1	1	1	1	1	6
NONE	OG0006605	1	1	1	1	1	1	6
NONE	OG0006606	1	1	1	1	1	1	6
NONE	OG0006607	1	1	1	1	1	1	6
NONE	OG0006608	1	1	1	1	1	1	6
NONE	OG0006609	2	0	1	1	1	1	6
NONE	OG0006610	1	1	1	1	1	1	6
NONE	OG0006611	1	1	1	1	1	1	6
NONE	OG0006612	1	1	1	1	1	1	6
NONE	OG0006613	1	1	1	1	1	1	6
NONE	OG0006614	1	1	1	1	1	1	6
NONE	OG0006615	1	1	1	1	1	1	6
NONE	OG0006616	1	1	1	1	1	1	6
NONE	OG0006617	1	1	1	1	1	1	6
NONE	OG0006618	2	1	1	1	0	1	6
NONE	OG0006619	1	1	1	1	1	1	6
NONE	OG0006620	1	1	1	1	1	1	6
NONE	OG0006621	1	0	1	3	0	1	6
NONE	OG0006622	1	1	1	1	1	1	6
NONE	OG0006623	1	1	1	1	1	1	6
NONE	OG0006624	1	1	1	1	1	1	6
NONE	OG0006625	1	1	1	1	1	1	6
NONE	OG0006626	1	1	1	1	1	1	6
NONE	OG0006627	1	1	1	1	1	1	6
NONE	OG0006628	1	1	1	2	0	1	6
NONE	OG0006629	1	1	1	1	1	1	6
NONE	OG0006630	1	1	1	1	1	1	6
NONE	OG0006631	1	1	1	1	1	1	6
NONE	OG0006632	1	1	1	1	1	1	6
NONE	OG0006633	2	0	1	3	0	0	6
NONE	OG0006634	1	1	1	1	1	1	6
NONE	OG0006635	1	1	1	1	1	1	6
NONE	OG0006636	1	1	1	1	1	1	6
NONE	OG0006637	1	1	1	1	1	1	6
NONE	OG0006638	1	1	1	1	1	1	6
NONE	OG0006639	1	1	1	1	1	1	6
NONE	OG0006640	2	1	1	1	0	1	6
NONE	OG0006641	2	0	1	1	1	1	6
NONE	OG0006642	1	1	1	1	1	1	6
NONE	OG0006643	1	1	1	1	1	1	6
NONE	OG0006644	1	1	1	1	1	1	6
NONE	OG0006645	1	1	1	1	1	1	6
NONE	OG0006646	1	1	1	1	1	1	6
NONE	OG0006647	1	1	1	1	1	1	6
NONE	OG0006648	1	1	1	2	0	1	6
NONE	OG0006649	1	0	1	2	1	1	6
NONE	OG0006650	1	0	2	0	0	3	6
NONE	OG0006651	1	1	1	1	1	1	6
NONE	OG0006652	1	1	1	1	1	1	6
NONE	OG0006653	1	1	1	1	1	1	6
NONE	OG0006654	1	1	1	1	1	1	6
NONE	OG0006655	1	1	1	1	1	1	6
NONE	OG0006656	1	2	1	1	0	1	6
NONE	OG0006657	1	1	1	1	1	1	6
NONE	OG0006658	1	1	1	1	1	1	6
NONE	OG0006659	1	1	1	1	1	1	6
NONE	OG0006660	1	1	1	1	1	1	6
NONE	OG0006661	1	1	1	1	1	1	6
NONE	OG0006662	1	1	1	1	1	1	6
NONE	OG0006663	1	1	1	1	1	1	6
NONE	OG0006664	3	0	1	1	0	1	6
NONE	OG0006665	1	1	1	1	1	1	6
NONE	OG0006666	1	0	1	2	1	1	6
NONE	OG0006667	1	1	1	1	1	1	6
NONE	OG0006668	1	1	1	1	1	1	6
NONE	OG0006669	1	1	1	1	1	1	6
NONE	OG0006670	1	1	1	1	1	1	6
NONE	OG0006671	1	1	1	1	1	1	6
NONE	OG0006672	1	1	1	1	1	1	6
NONE	OG0006673	1	1	1	1	1	1	6
NONE	OG0006674	1	1	1	1	1	1	6
NONE	OG0006675	1	1	1	1	1	1	6
NONE	OG0006676	1	1	1	1	1	1	6
NONE	OG0006677	1	1	1	1	1	1	6
NONE	OG0006678	1	1	1	1	1	1	6
NONE	OG0006679	1	1	1	1	1	1	6
NONE	OG0006680	1	1	1	1	1	1	6
NONE	OG0006681	1	1	1	1	1	1	6
NONE	OG0006682	1	1	1	1	1	1	6
NONE	OG0006683	1	1	1	1	1	1	6
NONE	OG0006684	1	1	1	1	1	1	6
NONE	OG0006685	1	1	1	1	1	1	6
NONE	OG0006686	1	1	1	1	1	1	6
NONE	OG0006687	1	1	1	1	1	1	6
NONE	OG0006688	1	1	1	1	1	1	6
NONE	OG0006689	1	1	1	1	1	1	6
NONE	OG0006690	1	1	1	1	1	1	6
NONE	OG0006691	1	1	1	1	1	1	6
NONE	OG0006692	1	1	1	1	1	1	6
NONE	OG0006693	1	1	1	1	1	1	6
NONE	OG0006694	1	1	1	1	1	1	6
NONE	OG0006695	1	1	1	1	1	1	6
NONE	OG0006696	1	1	1	1	1	1	6
NONE	OG0006697	1	1	1	1	1	1	6
NONE	OG0006698	1	1	1	1	1	1	6
NONE	OG0006699	1	1	1	1	1	1	6
NONE	OG0006700	1	1	1	1	1	1	6
NONE	OG0006701	1	1	1	1	1	1	6
NONE	OG0006702	1	1	1	1	1	1	6
NONE	OG0006703	1	1	1	1	1	1	6
NONE	OG0006704	1	1	1	1	1	1	6
NONE	OG0006705	1	1	1	1	1	1	6
NONE	OG0006706	1	1	1	1	1	1	6
NONE	OG0006707	2	0	1	1	1	1	6
NONE	OG0006708	1	1	1	1	1	1	6
NONE	OG0006709	1	1	1	1	1	1	6
NONE	OG0006710	1	1	1	1	1	1	6
NONE	OG0006711	1	1	1	1	1	1	6
NONE	OG0006712	1	1	1	1	1	1	6
NONE	OG0006713	2	0	2	1	0	1	6
NONE	OG0006714	1	1	1	1	1	1	6
NONE	OG0006715	1	1	1	1	1	1	6
NONE	OG0006716	1	1	1	1	1	1	6
NONE	OG0006717	1	1	1	1	1	1	6
NONE	OG0006718	1	1	1	1	1	1	6
NONE	OG0006719	1	1	1	1	1	1	6
NONE	OG0006720	1	1	1	1	1	1	6
NONE	OG0006721	1	1	1	1	0	2	6
NONE	OG0006722	1	1	1	1	1	1	6
NONE	OG0006723	1	1	1	1	1	1	6
NONE	OG0006724	1	1	1	1	1	1	6
NONE	OG0006725	1	1	1	1	1	1	6
NONE	OG0006726	1	1	1	1	1	1	6
NONE	OG0006727	1	1	1	1	1	1	6
NONE	OG0006728	1	1	1	1	1	1	6
NONE	OG0006729	1	1	1	1	1	1	6
NONE	OG0006730	1	1	1	1	1	1	6
NONE	OG0006731	1	0	1	1	1	2	6
NONE	OG0006732	1	1	1	1	1	1	6
NONE	OG0006733	1	1	1	1	1	1	6
NONE	OG0006734	1	1	1	1	1	1	6
NONE	OG0006735	1	1	1	1	1	1	6
NONE	OG0006736	1	1	1	1	1	1	6
NONE	OG0006737	1	1	1	1	1	1	6
NONE	OG0006738	1	1	1	1	1	1	6
NONE	OG0006739	1	1	1	1	1	1	6
NONE	OG0006740	1	1	1	1	1	1	6
NONE	OG0006741	1	0	1	2	1	1	6
NONE	OG0006742	1	1	1	1	1	1	6
NONE	OG0006743	1	1	1	1	1	1	6
NONE	OG0006744	1	1	1	1	1	1	6
NONE	OG0006745	1	1	1	1	1	1	6
NONE	OG0006746	1	1	1	1	1	1	6
NONE	OG0006747	1	1	1	1	1	1	6
NONE	OG0006748	1	1	1	1	1	1	6
NONE	OG0006749	1	1	1	1	1	1	6
NONE	OG0006750	1	1	1	1	1	1	6
NONE	OG0006751	1	1	1	1	1	1	6
NONE	OG0006752	1	1	1	1	1	1	6
NONE	OG0006753	1	1	1	1	1	1	6
NONE	OG0006754	1	1	1	1	1	1	6
NONE	OG0006755	1	1	1	1	1	1	6
NONE	OG0006756	1	1	1	1	1	1	6
NONE	OG0006757	1	1	1	1	1	1	6
NONE	OG0006758	2	0	2	1	0	1	6
NONE	OG0006759	1	1	1	1	1	1	6
NONE	OG0006760	1	1	1	1	1	1	6
NONE	OG0006761	1	1	1	1	1	1	6
NONE	OG0006762	1	1	1	1	1	1	6
NONE	OG0006763	1	1	1	1	1	1	6
NONE	OG0006764	1	1	1	1	1	1	6
NONE	OG0006765	1	1	1	1	1	1	6
NONE	OG0006766	1	1	1	1	1	1	6
NONE	OG0006767	1	1	1	1	0	2	6
NONE	OG0006768	1	1	1	1	1	1	6
NONE	OG0006769	1	1	1	1	1	1	6
NONE	OG0006770	2	1	1	1	0	1	6
NONE	OG0006771	1	1	1	1	1	1	6
NONE	OG0006772	1	1	1	1	1	1	6
NONE	OG0006773	1	1	1	1	1	1	6
NONE	OG0006774	1	1	1	1	1	1	6
NONE	OG0006775	1	1	1	1	1	1	6
NONE	OG0006776	1	1	1	1	1	1	6
NONE	OG0006777	1	1	1	1	1	1	6
NONE	OG0006778	1	1	1	1	1	1	6
NONE	OG0006779	1	1	1	1	1	1	6
NONE	OG0006780	1	1	1	2	0	1	6
NONE	OG0006781	1	1	1	1	1	1	6
NONE	OG0006782	1	1	1	1	1	1	6
NONE	OG0006783	1	1	1	1	1	1	6
NONE	OG0006784	2	1	2	1	0	0	6
NONE	OG0006785	2	0	2	1	0	1	6
NONE	OG0006786	1	1	1	1	1	1	6
NONE	OG0006787	1	1	1	1	1	1	6
NONE	OG0006788	1	1	1	1	1	1	6
NONE	OG0006789	1	1	1	1	1	1	6
NONE	OG0006790	1	1	1	1	1	1	6
NONE	OG0006791	1	1	1	1	1	1	6
NONE	OG0006792	1	1	1	1	1	1	6
NONE	OG0006793	1	1	1	1	1	1	6
NONE	OG0006794	1	1	1	1	1	1	6
NONE	OG0006795	1	1	1	1	1	1	6
NONE	OG0006796	1	1	1	1	1	1	6
NONE	OG0006797	1	1	1	1	1	1	6
NONE	OG0006798	1	1	1	1	1	1	6
NONE	OG0006799	1	1	1	1	1	1	6
NONE	OG0006800	1	1	1	1	1	1	6
NONE	OG0006801	1	1	1	1	1	1	6
NONE	OG0006802	1	1	1	1	1	1	6
NONE	OG0006803	1	1	1	1	1	1	6
NONE	OG0006804	1	1	1	1	1	1	6
NONE	OG0006805	1	1	1	1	1	1	6
NONE	OG0006806	1	1	1	1	1	1	6
NONE	OG0006807	1	1	1	1	1	1	6
NONE	OG0006808	1	1	2	1	0	1	6
NONE	OG0006809	1	1	2	1	0	1	6
NONE	OG0006810	1	1	1	1	1	1	6
NONE	OG0006811	1	1	1	1	1	1	6
NONE	OG0006812	1	1	1	1	1	1	6
NONE	OG0006813	1	1	1	1	1	1	6
NONE	OG0006814	1	1	1	1	1	1	6
NONE	OG0006815	1	1	1	1	1	1	6
NONE	OG0006816	1	1	1	1	1	1	6
NONE	OG0006817	1	1	1	1	1	1	6
NONE	OG0006818	1	1	1	1	1	1	6
NONE	OG0006819	1	1	1	1	1	1	6
NONE	OG0006820	1	1	1	1	1	1	6
NONE	OG0006821	1	1	1	1	1	1	6
NONE	OG0006822	1	1	1	1	1	1	6
NONE	OG0006823	1	1	1	1	1	1	6
NONE	OG0006824	1	1	1	1	1	1	6
NONE	OG0006825	1	1	1	1	1	1	6
NONE	OG0006826	2	0	1	1	1	1	6
NONE	OG0006827	1	1	1	1	1	1	6
NONE	OG0006828	1	1	1	1	1	1	6
NONE	OG0006829	1	1	1	1	1	1	6
NONE	OG0006830	1	1	1	1	1	1	6
NONE	OG0006831	1	1	1	1	1	1	6
NONE	OG0006832	1	1	1	1	1	1	6
NONE	OG0006833	2	1	1	1	0	1	6
NONE	OG0006834	2	0	1	1	1	1	6
NONE	OG0006835	1	1	1	1	1	1	6
NONE	OG0006836	1	1	1	1	1	1	6
NONE	OG0006837	1	1	1	1	1	1	6
NONE	OG0006838	1	1	1	1	1	1	6
NONE	OG0006839	1	1	1	1	1	1	6
NONE	OG0006840	1	1	1	1	1	1	6
NONE	OG0006841	1	1	1	1	1	1	6
NONE	OG0006842	1	1	1	1	1	1	6
NONE	OG0006843	1	1	1	1	1	1	6
NONE	OG0006844	1	1	1	1	1	1	6
NONE	OG0006845	1	1	1	1	1	1	6
NONE	OG0006846	1	1	1	1	1	1	6
NONE	OG0006847	1	1	1	1	1	1	6
NONE	OG0006848	1	1	1	1	1	1	6
NONE	OG0006849	1	1	1	1	1	1	6
NONE	OG0006850	1	1	1	1	1	1	6
NONE	OG0006851	1	1	1	1	1	1	6
NONE	OG0006852	1	1	1	1	1	1	6
NONE	OG0006853	1	1	1	1	1	1	6
NONE	OG0006854	1	1	1	1	1	1	6
NONE	OG0006855	1	1	1	1	1	1	6
NONE	OG0006856	1	1	1	1	1	1	6
NONE	OG0006857	1	1	1	1	1	1	6
NONE	OG0006858	1	1	1	1	1	1	6
NONE	OG0006859	1	1	1	1	1	1	6
NONE	OG0006860	1	1	1	1	1	1	6
NONE	OG0006861	1	1	1	1	1	1	6
NONE	OG0006862	1	1	1	1	1	1	6
NONE	OG0006863	1	1	1	1	1	1	6
NONE	OG0006864	1	1	1	1	1	1	6
NONE	OG0006865	1	1	1	1	1	1	6
NONE	OG0006866	1	1	1	1	1	1	6
NONE	OG0006867	1	1	1	1	1	1	6
NONE	OG0006868	1	1	1	1	1	1	6
NONE	OG0006869	1	1	1	1	1	1	6
NONE	OG0006870	1	1	1	1	1	1	6
NONE	OG0006871	1	1	1	1	1	1	6
NONE	OG0006872	1	1	1	1	1	1	6
NONE	OG0006873	1	1	1	1	1	1	6
NONE	OG0006874	1	1	1	1	1	1	6
NONE	OG0006875	1	1	1	1	1	1	6
NONE	OG0006876	1	1	1	1	1	1	6
NONE	OG0006877	1	1	1	1	1	1	6
NONE	OG0006878	1	1	1	1	1	1	6
NONE	OG0006879	1	1	1	1	1	1	6
NONE	OG0006880	1	1	1	1	1	1	6
NONE	OG0006881	1	1	1	1	1	1	6
NONE	OG0006882	1	1	1	1	1	1	6
NONE	OG0006883	1	1	1	1	1	1	6
NONE	OG0006884	1	1	1	1	1	1	6
NONE	OG0006885	1	1	1	1	1	1	6
NONE	OG0006886	1	1	1	1	1	1	6
NONE	OG0006887	1	1	1	1	1	1	6
NONE	OG0006888	1	1	1	1	1	1	6
NONE	OG0006889	1	1	1	1	1	1	6
NONE	OG0006890	1	1	1	1	1	1	6
NONE	OG0006891	1	1	1	1	1	1	6
NONE	OG0006892	1	1	1	1	1	1	6
NONE	OG0006893	1	1	1	1	1	1	6
NONE	OG0006894	1	1	1	1	1	1	6
NONE	OG0006895	1	1	1	1	1	1	6
NONE	OG0006896	1	1	1	1	1	1	6
NONE	OG0006897	1	1	1	1	1	1	6
NONE	OG0006898	1	1	1	1	1	1	6
NONE	OG0006899	1	1	1	1	1	1	6
NONE	OG0006900	1	1	1	1	1	1	6
NONE	OG0006901	1	1	1	1	1	1	6
NONE	OG0006902	1	1	1	1	1	1	6
NONE	OG0006903	1	1	1	1	1	1	6
NONE	OG0006904	1	1	1	1	1	1	6
NONE	OG0006905	1	0	2	2	0	1	6
NONE	OG0006906	1	1	1	1	1	1	6
NONE	OG0006907	1	1	1	1	1	1	6
NONE	OG0006908	1	1	2	1	0	1	6
NONE	OG0006909	1	1	1	1	1	1	6
NONE	OG0006910	1	1	1	1	1	1	6
NONE	OG0006911	1	1	1	1	1	1	6
NONE	OG0006912	1	1	1	1	1	1	6
NONE	OG0006913	1	1	1	1	1	1	6
NONE	OG0006914	1	1	1	1	1	1	6
NONE	OG0006915	2	1	1	1	0	1	6
NONE	OG0006916	1	1	1	1	1	1	6
NONE	OG0006917	1	1	1	1	1	1	6
NONE	OG0006918	1	1	1	1	1	1	6
NONE	OG0006919	1	1	1	1	1	1	6
NONE	OG0006920	2	0	1	1	1	1	6
NONE	OG0006921	1	1	1	1	1	1	6
NONE	OG0006922	1	1	1	1	1	1	6
NONE	OG0006923	1	1	1	1	1	1	6
NONE	OG0006924	1	1	1	1	1	1	6
NONE	OG0006925	1	1	1	1	1	1	6
NONE	OG0006926	1	1	1	1	1	1	6
NONE	OG0006927	1	1	1	1	1	1	6
NONE	OG0006928	1	1	1	1	1	1	6
NONE	OG0006929	1	1	1	1	1	1	6
NONE	OG0006930	1	1	1	1	1	1	6
NONE	OG0006931	1	1	1	1	1	1	6
NONE	OG0006932	1	1	1	1	1	1	6
NONE	OG0006933	1	1	1	1	1	1	6
NONE	OG0006934	1	1	1	1	1	1	6
NONE	OG0006935	1	1	1	1	1	1	6
NONE	OG0006936	1	1	1	1	1	1	6
NONE	OG0006937	1	1	1	1	1	1	6
NONE	OG0006938	1	1	1	1	1	1	6
NONE	OG0006939	1	1	1	1	1	1	6
NONE	OG0006940	1	1	1	2	0	1	6
NONE	OG0006941	1	1	1	2	0	1	6
NONE	OG0006942	2	0	1	2	0	1	6
NONE	OG0006943	1	1	1	1	1	1	6
NONE	OG0006944	1	1	1	1	1	1	6
NONE	OG0006945	1	1	1	1	1	1	6
NONE	OG0006946	1	1	1	1	1	1	6
NONE	OG0006947	1	1	1	1	1	1	6
NONE	OG0006948	1	1	1	1	1	1	6
NONE	OG0006949	1	1	1	1	1	1	6
NONE	OG0006950	1	1	1	1	1	1	6
NONE	OG0006951	1	1	1	1	1	1	6
NONE	OG0006952	1	1	1	1	1	1	6
NONE	OG0006953	1	1	1	1	1	1	6
NONE	OG0006954	1	1	1	1	1	1	6
NONE	OG0006955	1	1	1	1	2	0	6
NONE	OG0006956	1	1	1	1	1	1	6
NONE	OG0006957	1	1	1	1	1	1	6
NONE	OG0006958	1	1	1	1	1	1	6
NONE	OG0006959	1	1	1	1	1	1	6
NONE	OG0006960	1	1	1	1	1	1	6
NONE	OG0006961	1	1	1	1	1	1	6
NONE	OG0006962	1	1	1	1	1	1	6
NONE	OG0006963	1	1	1	1	1	1	6
NONE	OG0006964	1	1	1	1	1	1	6
NONE	OG0006965	1	1	1	1	1	1	6
NONE	OG0006966	1	1	1	1	1	1	6
NONE	OG0006967	1	1	1	1	1	1	6
NONE	OG0006968	1	1	1	1	1	1	6
NONE	OG0006969	1	1	1	1	1	1	6
NONE	OG0006970	1	1	1	1	1	1	6
NONE	OG0006971	1	2	1	1	0	1	6
NONE	OG0006972	1	1	1	1	1	1	6
NONE	OG0006973	1	1	1	1	1	1	6
NONE	OG0006974	1	1	1	1	1	1	6
NONE	OG0006975	1	1	1	1	1	1	6
NONE	OG0006976	1	1	1	1	1	1	6
NONE	OG0006977	1	1	1	1	1	1	6
NONE	OG0006978	1	1	1	1	1	1	6
NONE	OG0006979	1	1	1	1	1	1	6
NONE	OG0006980	1	1	1	1	1	1	6
NONE	OG0006981	1	1	1	1	1	1	6
NONE	OG0006982	1	1	1	1	1	1	6
NONE	OG0006983	1	1	1	1	1	1	6
NONE	OG0006984	1	1	1	1	1	1	6
NONE	OG0006985	1	1	1	1	1	1	6
NONE	OG0006986	1	0	2	1	1	1	6
NONE	OG0006987	1	1	1	1	1	1	6
NONE	OG0006988	1	1	1	1	1	1	6
NONE	OG0006989	1	1	1	1	1	1	6
NONE	OG0006990	1	1	1	1	1	1	6
NONE	OG0006991	1	2	1	1	0	1	6
NONE	OG0006992	1	1	1	1	1	1	6
NONE	OG0006993	1	1	1	1	1	1	6
NONE	OG0006994	1	1	1	1	1	1	6
NONE	OG0006995	1	1	1	1	1	1	6
NONE	OG0006996	1	1	1	1	1	1	6
NONE	OG0006997	1	1	1	1	1	1	6
NONE	OG0006998	1	1	1	1	1	1	6
NONE	OG0006999	1	1	1	1	1	1	6
NONE	OG0007000	1	1	1	1	1	1	6
NONE	OG0007001	1	1	1	1	1	1	6
NONE	OG0007002	1	1	1	1	1	1	6
NONE	OG0007003	1	1	1	1	1	1	6
NONE	OG0007004	1	1	1	1	1	1	6
NONE	OG0007005	2	2	1	1	0	0	6
NONE	OG0007006	1	1	1	1	1	1	6
NONE	OG0007007	2	0	1	1	1	1	6
NONE	OG0007008	2	0	1	1	1	1	6
NONE	OG0007009	1	1	1	1	1	1	6
NONE	OG0007010	1	1	1	1	1	1	6
NONE	OG0007011	1	1	1	1	1	1	6
NONE	OG0007012	1	1	1	1	1	1	6
NONE	OG0007013	1	1	1	1	1	1	6
NONE	OG0007014	1	1	1	1	1	1	6
NONE	OG0007015	1	1	1	1	1	1	6
NONE	OG0007016	1	1	1	1	1	1	6
NONE	OG0007017	1	1	1	1	1	1	6
NONE	OG0007018	1	1	1	1	1	1	6
NONE	OG0007019	1	1	1	1	1	1	6
NONE	OG0007020	1	1	1	1	1	1	6
NONE	OG0007021	1	1	1	1	1	1	6
NONE	OG0007022	1	1	1	1	1	1	6
NONE	OG0007023	1	1	1	1	0	2	6
NONE	OG0007024	1	1	1	1	1	1	6
NONE	OG0007025	1	1	1	1	1	1	6
NONE	OG0007026	1	1	1	1	1	1	6
NONE	OG0007027	1	1	1	1	1	1	6
NONE	OG0007028	1	1	1	1	1	1	6
NONE	OG0007029	1	1	1	1	1	1	6
NONE	OG0007030	1	1	1	1	1	1	6
NONE	OG0007031	1	1	1	1	1	1	6
NONE	OG0007032	1	1	1	1	1	1	6
NONE	OG0007033	1	1	1	1	1	1	6
NONE	OG0007034	1	1	1	1	1	1	6
NONE	OG0007035	1	1	1	1	1	1	6
NONE	OG0007036	1	1	1	1	1	1	6
NONE	OG0007037	1	1	1	1	1	1	6
NONE	OG0007038	2	0	2	1	0	1	6
NONE	OG0007039	1	1	1	1	1	1	6
NONE	OG0007040	1	1	1	1	1	1	6
NONE	OG0007041	1	1	1	1	1	1	6
NONE	OG0007042	1	1	1	1	1	1	6
NONE	OG0007043	1	1	1	1	1	1	6
NONE	OG0007044	1	1	1	1	1	1	6
NONE	OG0007045	1	1	1	1	1	1	6
NONE	OG0007046	1	1	1	1	1	1	6
NONE	OG0007047	1	1	1	1	1	1	6
NONE	OG0007048	1	1	1	1	1	1	6
NONE	OG0007049	1	1	1	1	1	1	6
NONE	OG0007050	1	1	1	1	1	1	6
NONE	OG0007051	1	1	1	1	1	1	6
NONE	OG0007052	1	1	1	1	1	1	6
NONE	OG0007053	1	1	1	1	1	1	6
NONE	OG0007054	1	1	1	1	1	1	6
NONE	OG0007055	1	1	1	1	1	1	6
NONE	OG0007056	1	1	1	1	1	1	6
NONE	OG0007057	1	1	1	1	1	1	6
NONE	OG0007058	1	1	1	1	1	1	6
NONE	OG0007059	1	1	1	1	1	1	6
NONE	OG0007060	1	1	1	1	1	1	6
NONE	OG0007061	1	1	1	1	1	1	6
NONE	OG0007062	1	0	1	1	1	2	6
NONE	OG0007063	1	1	1	1	1	1	6
NONE	OG0007064	1	1	1	1	1	1	6
NONE	OG0007065	1	1	1	1	1	1	6
NONE	OG0007066	1	1	1	1	1	1	6
NONE	OG0007067	1	1	1	1	1	1	6
NONE	OG0007068	1	1	1	1	1	1	6
NONE	OG0007069	1	1	1	1	1	1	6
NONE	OG0007070	1	1	1	1	1	1	6
NONE	OG0007071	1	1	2	1	0	1	6
NONE	OG0007072	1	1	1	1	1	1	6
NONE	OG0007073	1	0	2	1	1	1	6
NONE	OG0007074	1	1	1	1	1	1	6
NONE	OG0007075	1	1	1	1	1	1	6
NONE	OG0007076	1	1	1	1	1	1	6
NONE	OG0007077	1	1	1	1	1	1	6
NONE	OG0007078	2	0	1	2	0	1	6
NONE	OG0007079	2	0	1	1	1	1	6
NONE	OG0007080	2	1	1	1	0	1	6
NONE	OG0007081	1	1	1	1	1	1	6
NONE	OG0007082	1	1	1	1	1	1	6
NONE	OG0007083	1	1	1	1	1	1	6
NONE	OG0007084	1	1	1	1	1	1	6
NONE	OG0007085	1	1	1	1	1	1	6
NONE	OG0007086	1	1	1	1	1	1	6
NONE	OG0007087	1	1	1	1	1	1	6
NONE	OG0007088	1	1	1	1	1	1	6
NONE	OG0007089	1	1	1	1	1	1	6
NONE	OG0007090	1	1	1	1	1	1	6
NONE	OG0007091	2	1	1	1	0	1	6
NONE	OG0007092	1	1	1	1	1	1	6
NONE	OG0007093	1	1	1	1	1	1	6
NONE	OG0007094	1	1	1	1	1	1	6
NONE	OG0007095	1	1	1	1	1	1	6
NONE	OG0007096	1	1	1	1	1	1	6
NONE	OG0007097	1	1	1	1	1	1	6
NONE	OG0007098	1	1	1	1	1	1	6
NONE	OG0007099	1	1	1	1	1	1	6
NONE	OG0007100	1	1	1	1	1	1	6
NONE	OG0007101	1	1	1	1	1	1	6
NONE	OG0007102	1	1	1	1	1	1	6
NONE	OG0007103	1	1	1	1	1	1	6
NONE	OG0007104	1	1	1	1	1	1	6
NONE	OG0007105	1	1	1	1	1	1	6
NONE	OG0007106	1	1	1	1	1	1	6
NONE	OG0007107	1	1	1	1	1	1	6
NONE	OG0007108	1	1	1	1	1	1	6
NONE	OG0007109	1	1	1	1	1	1	6
NONE	OG0007110	1	1	1	1	1	1	6
NONE	OG0007111	1	1	1	1	1	1	6
NONE	OG0007112	1	1	1	1	1	1	6
NONE	OG0007113	1	1	1	1	1	1	6
NONE	OG0007114	1	0	1	1	2	1	6
NONE	OG0007115	1	1	1	1	1	1	6
NONE	OG0007116	1	1	1	1	1	1	6
NONE	OG0007117	2	0	1	1	1	1	6
NONE	OG0007118	1	1	1	1	1	1	6
NONE	OG0007119	1	1	1	1	1	1	6
NONE	OG0007120	1	1	1	1	1	1	6
NONE	OG0007121	1	0	1	2	0	2	6
NONE	OG0007122	1	1	1	1	1	1	6
NONE	OG0007123	1	1	1	1	1	1	6
NONE	OG0007124	1	1	1	1	1	1	6
NONE	OG0007125	1	1	1	1	1	1	6
NONE	OG0007126	1	1	1	1	1	1	6
NONE	OG0007127	1	1	1	1	1	1	6
NONE	OG0007128	1	1	1	1	1	1	6
NONE	OG0007129	1	1	1	1	1	1	6
NONE	OG0007130	1	1	1	1	1	1	6
NONE	OG0007131	1	1	1	1	1	1	6
NONE	OG0007132	1	1	1	1	1	1	6
NONE	OG0007133	1	1	1	1	1	1	6
NONE	OG0007134	1	1	1	1	1	1	6
NONE	OG0007135	1	1	1	1	1	1	6
NONE	OG0007136	1	1	1	1	1	1	6
NONE	OG0007137	1	1	1	1	1	1	6
NONE	OG0007138	1	1	1	1	1	1	6
NONE	OG0007139	1	0	2	1	1	1	6
NONE	OG0007140	1	1	1	1	1	1	6
NONE	OG0007141	1	1	1	1	1	1	6
NONE	OG0007142	1	1	1	1	1	1	6
NONE	OG0007143	1	1	1	1	1	1	6
NONE	OG0007144	1	1	1	1	1	1	6
NONE	OG0007145	1	1	2	1	0	1	6
NONE	OG0007146	1	1	1	1	1	1	6
NONE	OG0007147	1	1	1	1	1	1	6
NONE	OG0007148	1	1	1	1	1	1	6
NONE	OG0007149	1	1	1	1	1	1	6
NONE	OG0007150	1	1	1	1	1	1	6
NONE	OG0007151	1	1	1	1	1	1	6
NONE	OG0007152	1	1	1	1	1	1	6
NONE	OG0007153	1	1	1	1	1	1	6
NONE	OG0007154	1	1	1	1	1	1	6
NONE	OG0007155	1	1	1	1	1	1	6
NONE	OG0007156	1	1	1	1	1	1	6
NONE	OG0007157	1	1	1	1	1	1	6
NONE	OG0007158	1	1	1	1	1	1	6
NONE	OG0007159	1	1	1	1	1	1	6
NONE	OG0007160	1	1	1	1	1	1	6
NONE	OG0007161	1	1	1	1	1	1	6
NONE	OG0007162	1	1	1	1	1	1	6
NONE	OG0007163	1	1	1	1	1	1	6
NONE	OG0007164	1	1	1	1	1	1	6
NONE	OG0007165	1	1	1	1	1	1	6
NONE	OG0007166	1	1	1	1	1	1	6
NONE	OG0007167	1	1	1	1	1	1	6
NONE	OG0007168	1	0	1	1	2	1	6
NONE	OG0007169	1	1	1	1	1	1	6
NONE	OG0007170	1	1	1	1	1	1	6
NONE	OG0007171	1	1	1	1	1	1	6
NONE	OG0007172	1	1	1	1	1	1	6
NONE	OG0007173	1	1	1	1	1	1	6
NONE	OG0007174	1	1	1	1	1	1	6
NONE	OG0007175	1	1	1	1	1	1	6
NONE	OG0007176	1	1	1	1	1	1	6
NONE	OG0007177	1	1	1	1	1	1	6
NONE	OG0007178	1	1	1	1	1	1	6
NONE	OG0007179	1	1	1	1	1	1	6
NONE	OG0007180	1	1	1	1	1	1	6
NONE	OG0007181	1	1	1	1	1	1	6
NONE	OG0007182	1	1	1	1	1	1	6
NONE	OG0007183	1	1	1	1	1	1	6
NONE	OG0007184	1	1	1	1	1	1	6
NONE	OG0007185	1	1	1	1	1	1	6
NONE	OG0007186	1	1	1	1	1	1	6
NONE	OG0007187	1	1	1	1	1	1	6
NONE	OG0007188	1	1	1	1	1	1	6
NONE	OG0007189	1	1	1	1	1	1	6
NONE	OG0007190	1	1	1	1	1	1	6
NONE	OG0007191	1	1	1	1	1	1	6
NONE	OG0007192	1	1	1	1	1	1	6
NONE	OG0007193	1	1	1	1	1	1	6
NONE	OG0007194	1	1	1	1	1	1	6
NONE	OG0007195	1	1	1	1	1	1	6
NONE	OG0007196	1	1	1	1	1	1	6
NONE	OG0007197	1	1	1	1	1	1	6
NONE	OG0007198	1	1	1	1	1	1	6
NONE	OG0007199	1	1	1	1	1	1	6
NONE	OG0007200	1	1	1	1	1	1	6
NONE	OG0007201	1	1	1	1	1	1	6
NONE	OG0007202	1	1	1	1	1	1	6
NONE	OG0007203	1	0	1	2	1	1	6
NONE	OG0007204	1	1	1	2	0	1	6
NONE	OG0007205	1	1	1	1	1	1	6
NONE	OG0007206	1	1	1	1	1	1	6
NONE	OG0007207	1	1	1	1	1	1	6
NONE	OG0007208	1	1	1	1	1	1	6
NONE	OG0007209	1	1	1	1	1	1	6
NONE	OG0007210	1	1	1	1	1	1	6
NONE	OG0007211	1	1	1	1	1	1	6
NONE	OG0007212	1	1	1	1	1	1	6
NONE	OG0007213	2	0	1	1	1	1	6
NONE	OG0007214	1	1	1	1	1	1	6
NONE	OG0007215	1	0	1	2	1	1	6
NONE	OG0007216	1	1	3	0	0	1	6
NONE	OG0007217	1	1	1	1	1	1	6
NONE	OG0007218	1	0	2	1	1	1	6
NONE	OG0007219	1	1	1	1	1	1	6
NONE	OG0007220	1	1	1	1	1	1	6
NONE	OG0007221	1	1	1	1	1	1	6
NONE	OG0007222	1	1	1	1	1	1	6
NONE	OG0007223	1	1	1	1	1	1	6
NONE	OG0007224	1	1	1	1	1	1	6
NONE	OG0007225	1	1	1	1	1	1	6
NONE	OG0007226	1	1	1	1	1	1	6
NONE	OG0007227	1	1	1	1	1	1	6
NONE	OG0007228	1	1	1	1	1	1	6
NONE	OG0007229	1	1	1	1	1	1	6
NONE	OG0007230	1	1	1	1	1	1	6
NONE	OG0007231	2	0	1	1	1	1	6
NONE	OG0007232	1	1	1	1	1	1	6
NONE	OG0007233	1	1	1	1	1	1	6
NONE	OG0007234	1	1	1	1	1	1	6
NONE	OG0007235	1	1	1	1	1	1	6
NONE	OG0007236	1	1	1	1	1	1	6
NONE	OG0007237	1	1	1	1	1	1	6
NONE	OG0007238	1	1	1	1	1	1	6
NONE	OG0007239	1	1	1	1	1	1	6
NONE	OG0007240	1	1	1	1	1	1	6
NONE	OG0007241	1	1	1	1	1	1	6
NONE	OG0007242	1	1	1	1	1	1	6
NONE	OG0007243	1	1	1	1	1	1	6
NONE	OG0007244	1	1	1	1	1	1	6
NONE	OG0007245	1	1	1	1	1	1	6
NONE	OG0007246	1	1	1	1	1	1	6
NONE	OG0007247	1	1	1	1	1	1	6
NONE	OG0007248	1	1	1	1	1	1	6
NONE	OG0007249	1	1	1	1	1	1	6
NONE	OG0007250	1	1	1	1	1	1	6
NONE	OG0007251	1	1	1	1	1	1	6
NONE	OG0007252	1	1	1	1	1	1	6
NONE	OG0007253	1	1	1	1	1	1	6
NONE	OG0007254	1	1	1	1	1	1	6
NONE	OG0007255	1	1	1	1	1	1	6
NONE	OG0007256	1	0	1	3	0	1	6
NONE	OG0007257	1	1	1	2	0	1	6
NONE	OG0007258	1	1	1	1	1	1	6
NONE	OG0007259	1	1	1	1	1	1	6
NONE	OG0007260	1	1	1	1	1	1	6
NONE	OG0007261	1	1	1	1	1	1	6
NONE	OG0007262	1	1	1	1	1	1	6
NONE	OG0007263	1	1	1	1	1	1	6
NONE	OG0007264	1	1	1	1	1	1	6
NONE	OG0007265	1	1	1	1	1	1	6
NONE	OG0007266	1	1	1	1	1	1	6
NONE	OG0007267	1	1	1	1	1	1	6
NONE	OG0007268	1	1	1	1	1	1	6
NONE	OG0007269	1	1	1	1	1	1	6
NONE	OG0007270	1	1	1	1	1	1	6
NONE	OG0007271	1	1	1	1	1	1	6
NONE	OG0007272	1	1	1	1	1	1	6
NONE	OG0007273	1	1	1	1	1	1	6
NONE	OG0007274	1	1	1	1	1	1	6
NONE	OG0007275	1	1	1	1	1	1	6
NONE	OG0007276	1	1	1	1	1	1	6
NONE	OG0007277	1	1	1	1	1	1	6
NONE	OG0007278	1	1	1	1	1	1	6
NONE	OG0007279	1	1	1	1	1	1	6
NONE	OG0007280	1	1	1	1	1	1	6
NONE	OG0007281	1	1	1	1	1	1	6
NONE	OG0007282	2	0	1	2	0	1	6
NONE	OG0007283	1	1	1	1	1	1	6
NONE	OG0007284	1	1	1	1	1	1	6
NONE	OG0007285	1	1	1	1	1	1	6
NONE	OG0007286	1	1	1	1	1	1	6
NONE	OG0007287	1	1	1	1	1	1	6
NONE	OG0007288	1	1	1	1	1	1	6
NONE	OG0007289	1	0	1	1	1	2	6
NONE	OG0007290	1	1	1	1	1	1	6
NONE	OG0007291	1	0	1	1	2	1	6
NONE	OG0007292	1	1	1	1	1	1	6
NONE	OG0007293	1	1	1	1	1	1	6
NONE	OG0007294	1	1	1	1	1	1	6
NONE	OG0007295	1	1	1	1	1	1	6
NONE	OG0007296	1	1	1	1	1	1	6
NONE	OG0007297	1	1	1	1	1	1	6
NONE	OG0007298	1	1	1	1	1	1	6
NONE	OG0007299	1	2	1	1	0	1	6
NONE	OG0007300	1	1	1	1	1	1	6
NONE	OG0007301	1	1	1	1	1	1	6
NONE	OG0007302	1	1	1	1	1	1	6
NONE	OG0007303	1	1	1	1	1	1	6
NONE	OG0007304	1	1	1	1	1	1	6
NONE	OG0007305	1	1	1	1	1	1	6
NONE	OG0007306	1	1	1	1	1	1	6
NONE	OG0007307	1	1	1	1	1	1	6
NONE	OG0007308	1	1	1	1	1	1	6
NONE	OG0007309	1	1	1	1	1	1	6
NONE	OG0007310	1	1	1	1	1	1	6
NONE	OG0007311	1	1	1	1	1	1	6
NONE	OG0007312	2	1	1	0	1	1	6
NONE	OG0007313	1	1	1	1	1	1	6
NONE	OG0007314	1	1	1	1	1	1	6
NONE	OG0007315	1	1	1	1	1	1	6
NONE	OG0007316	1	1	1	1	1	1	6
NONE	OG0007317	1	1	1	1	1	1	6
NONE	OG0007318	1	1	1	1	1	1	6
NONE	OG0007319	1	1	1	1	1	1	6
NONE	OG0007320	1	1	1	1	1	1	6
NONE	OG0007321	1	1	1	1	1	1	6
NONE	OG0007322	1	1	1	1	1	1	6
NONE	OG0007323	1	1	1	1	1	1	6
NONE	OG0007324	1	1	1	1	1	1	6
NONE	OG0007325	1	1	1	1	1	1	6
NONE	OG0007326	1	1	1	1	1	1	6
NONE	OG0007327	1	1	1	1	1	1	6
NONE	OG0007328	1	1	1	1	1	1	6
NONE	OG0007329	1	1	1	1	1	1	6
NONE	OG0007330	1	1	1	1	1	1	6
NONE	OG0007331	2	0	1	1	1	1	6
NONE	OG0007332	1	1	1	1	1	1	6
NONE	OG0007333	1	1	1	1	1	1	6
NONE	OG0007334	1	1	1	1	1	1	6
NONE	OG0007335	1	1	1	1	1	1	6
NONE	OG0007336	1	1	1	1	1	1	6
NONE	OG0007337	1	1	1	1	1	1	6
NONE	OG0007338	1	1	1	1	1	1	6
NONE	OG0007339	1	1	1	1	1	1	6
NONE	OG0007340	1	1	1	1	1	1	6
NONE	OG0007341	1	1	1	1	1	1	6
NONE	OG0007342	1	1	1	1	1	1	6
NONE	OG0007343	1	1	1	1	1	1	6
NONE	OG0007344	1	1	1	1	1	1	6
NONE	OG0007345	1	1	1	1	1	1	6
NONE	OG0007346	1	1	1	1	1	1	6
NONE	OG0007347	1	1	1	1	1	1	6
NONE	OG0007348	1	1	1	1	1	1	6
NONE	OG0007349	1	1	1	1	1	1	6
NONE	OG0007350	1	1	1	1	1	1	6
NONE	OG0007351	1	1	1	1	1	1	6
NONE	OG0007352	1	1	1	2	0	1	6
NONE	OG0007353	1	1	1	1	1	1	6
NONE	OG0007354	1	1	1	1	1	1	6
NONE	OG0007355	1	1	1	1	1	1	6
NONE	OG0007356	1	1	1	1	1	1	6
NONE	OG0007357	1	1	1	1	1	1	6
NONE	OG0007358	1	1	1	1	1	1	6
NONE	OG0007359	1	1	1	1	1	1	6
NONE	OG0007360	1	1	1	1	1	1	6
NONE	OG0007361	1	1	1	1	1	1	6
NONE	OG0007362	1	1	2	1	1	0	6
NONE	OG0007363	1	1	1	1	1	1	6
NONE	OG0007364	1	1	1	1	1	1	6
NONE	OG0007365	1	0	2	2	0	1	6
NONE	OG0007366	1	1	1	1	1	1	6
NONE	OG0007367	1	0	1	1	2	1	6
NONE	OG0007368	1	1	1	1	1	1	6
NONE	OG0007369	1	0	5	0	0	0	6
NONE	OG0007370	1	1	1	1	1	1	6
NONE	OG0007371	1	1	1	1	1	1	6
NONE	OG0007372	1	1	1	1	1	1	6
NONE	OG0007373	1	1	1	1	1	1	6
NONE	OG0007374	1	1	1	1	1	1	6
NONE	OG0007375	1	1	1	1	1	1	6
NONE	OG0007376	1	1	1	1	1	1	6
NONE	OG0007377	1	1	1	1	1	1	6
NONE	OG0007378	1	1	1	1	1	1	6
NONE	OG0007379	1	1	1	1	1	1	6
NONE	OG0007380	1	1	1	1	1	1	6
NONE	OG0007381	1	1	1	1	1	1	6
NONE	OG0007382	1	1	1	1	1	1	6
NONE	OG0007383	1	1	1	1	1	1	6
NONE	OG0007384	1	0	1	2	1	1	6
NONE	OG0007385	1	1	1	1	1	1	6
NONE	OG0007386	1	1	1	1	1	1	6
NONE	OG0007387	1	1	1	1	1	1	6
NONE	OG0007388	1	1	1	1	1	1	6
NONE	OG0007389	1	1	1	1	1	1	6
NONE	OG0007390	1	1	1	1	1	1	6
NONE	OG0007391	1	1	1	1	1	1	6
NONE	OG0007392	1	1	1	1	1	1	6
NONE	OG0007393	1	1	1	1	1	1	6
NONE	OG0007394	1	0	1	2	1	1	6
NONE	OG0007395	1	1	1	1	1	1	6
NONE	OG0007396	1	1	1	1	1	1	6
NONE	OG0007397	1	1	1	1	1	1	6
NONE	OG0007398	1	1	1	1	1	1	6
NONE	OG0007399	1	1	1	0	1	2	6
NONE	OG0007400	2	1	1	0	1	1	6
NONE	OG0007401	2	0	3	0	0	1	6
NONE	OG0007402	1	1	1	1	1	1	6
NONE	OG0007403	1	1	1	1	1	1	6
NONE	OG0007404	1	1	1	1	1	1	6
NONE	OG0007405	1	1	1	1	1	1	6
NONE	OG0007406	1	1	1	1	1	1	6
NONE	OG0007407	1	1	1	1	1	1	6
NONE	OG0007408	1	1	1	1	1	1	6
NONE	OG0007409	1	1	1	1	1	1	6
NONE	OG0007410	1	1	1	1	1	1	6
NONE	OG0007411	1	1	1	1	1	1	6
NONE	OG0007412	1	1	1	0	2	1	6
NONE	OG0007413	1	1	1	1	1	1	6
NONE	OG0007414	1	1	1	1	1	1	6
NONE	OG0007415	1	1	1	1	1	1	6
NONE	OG0007416	1	1	1	1	1	1	6
NONE	OG0007417	1	1	1	1	1	1	6
NONE	OG0007418	1	1	1	1	1	1	6
NONE	OG0007419	1	1	1	1	1	1	6
NONE	OG0007420	1	1	1	1	1	1	6
NONE	OG0007421	1	1	1	1	1	1	6
NONE	OG0007422	1	1	1	1	1	1	6
NONE	OG0007423	1	1	1	1	1	1	6
NONE	OG0007424	1	2	1	0	1	1	6
NONE	OG0007425	1	1	1	1	1	1	6
NONE	OG0007426	1	1	1	0	2	1	6
NONE	OG0007427	1	1	1	0	2	1	6
NONE	OG0007428	1	1	1	1	1	1	6
NONE	OG0007429	1	1	1	1	1	1	6
NONE	OG0007430	1	1	1	1	1	1	6
NONE	OG0007431	1	1	1	1	1	1	6
NONE	OG0007432	1	1	1	1	1	1	6
NONE	OG0007433	1	1	1	1	1	1	6
NONE	OG0007434	1	1	1	1	1	1	6
NONE	OG0007435	1	1	1	1	1	1	6
NONE	OG0007436	1	1	1	1	1	1	6
NONE	OG0007437	1	1	1	1	1	1	6
NONE	OG0007438	1	1	1	1	1	1	6
NONE	OG0007439	1	1	1	1	1	1	6
NONE	OG0007440	1	1	1	1	1	1	6
NONE	OG0007441	1	1	1	1	1	1	6
NONE	OG0007442	1	1	1	1	1	1	6
NONE	OG0007443	1	1	1	1	1	1	6
NONE	OG0007444	1	1	1	1	1	1	6
NONE	OG0007445	1	1	1	1	1	1	6
NONE	OG0007446	1	1	1	1	1	1	6
NONE	OG0007447	1	1	1	1	1	1	6
NONE	OG0007448	1	1	1	1	1	1	6
NONE	OG0007449	1	1	1	1	1	1	6
NONE	OG0007450	1	1	1	1	1	1	6
NONE	OG0007451	1	1	1	1	1	1	6
NONE	OG0007452	1	1	1	1	1	1	6
NONE	OG0007453	1	1	1	1	1	1	6
NONE	OG0007454	1	0	1	0	4	0	6
NONE	OG0007455	1	1	1	1	1	1	6
NONE	OG0007456	1	1	1	1	1	1	6
NONE	OG0007457	1	1	1	1	1	1	6
NONE	OG0007458	1	1	1	1	1	1	6
NONE	OG0007459	2	1	1	1	0	1	6
NONE	OG0007460	1	1	1	1	1	1	6
NONE	OG0007461	1	1	1	1	1	1	6
NONE	OG0007462	1	1	1	1	1	1	6
NONE	OG0007463	1	1	1	1	1	1	6
NONE	OG0007464	1	1	1	1	1	1	6
NONE	OG0007465	1	1	1	1	1	1	6
NONE	OG0007466	1	1	1	1	1	1	6
NONE	OG0007467	1	0	1	2	1	1	6
NONE	OG0007468	1	1	1	1	1	1	6
NONE	OG0007469	1	1	1	1	1	1	6
NONE	OG0007470	1	1	1	1	1	1	6
NONE	OG0007471	1	1	1	1	1	1	6
NONE	OG0007472	1	1	1	1	1	1	6
NONE	OG0007473	1	1	1	1	1	1	6
NONE	OG0007474	1	1	1	1	1	1	6
NONE	OG0007475	1	1	1	1	1	1	6
NONE	OG0007476	1	1	1	1	1	1	6
NONE	OG0007477	1	1	1	1	1	1	6
NONE	OG0007478	1	1	1	1	1	1	6
NONE	OG0007479	1	1	1	1	1	1	6
NONE	OG0007480	1	1	1	1	1	1	6
NONE	OG0007481	1	1	1	1	1	1	6
NONE	OG0007482	1	1	1	1	1	1	6
NONE	OG0007483	1	1	1	1	1	1	6
NONE	OG0007484	1	1	1	1	1	1	6
NONE	OG0007485	1	1	1	1	1	1	6
NONE	OG0007486	1	1	1	1	1	1	6
NONE	OG0007487	1	1	1	1	1	1	6
NONE	OG0007488	1	1	1	1	1	1	6
NONE	OG0007489	1	1	1	1	1	1	6
NONE	OG0007490	1	1	1	1	1	1	6
NONE	OG0007491	1	1	1	1	1	1	6
NONE	OG0007492	1	1	1	1	1	1	6
NONE	OG0007493	1	1	1	1	1	1	6
NONE	OG0007494	1	1	1	1	1	1	6
NONE	OG0007495	1	1	1	1	1	1	6
NONE	OG0007496	1	1	1	1	1	1	6
NONE	OG0007497	1	1	1	1	1	1	6
NONE	OG0007498	1	1	1	1	1	1	6
NONE	OG0007499	1	1	1	1	1	1	6
NONE	OG0007500	1	1	1	1	1	1	6
NONE	OG0007501	1	1	1	1	1	1	6
NONE	OG0007502	1	1	1	1	1	1	6
NONE	OG0007503	1	1	1	1	1	1	6
NONE	OG0007504	1	1	1	1	1	1	6
NONE	OG0007505	1	1	1	2	0	1	6
NONE	OG0007506	1	1	1	1	1	1	6
NONE	OG0007507	1	1	1	1	1	1	6
NONE	OG0007508	1	1	1	1	1	1	6
NONE	OG0007509	1	1	1	1	1	1	6
NONE	OG0007510	1	1	1	1	1	1	6
NONE	OG0007511	1	1	1	1	1	1	6
NONE	OG0007512	1	1	1	1	1	1	6
NONE	OG0007513	1	1	1	1	1	1	6
NONE	OG0007514	1	1	1	1	1	1	6
NONE	OG0007515	1	1	1	1	1	1	6
NONE	OG0007516	1	1	1	1	1	1	6
NONE	OG0007517	1	1	1	1	1	1	6
NONE	OG0007518	1	1	1	1	1	1	6
NONE	OG0007519	1	1	1	1	1	1	6
NONE	OG0007520	1	1	1	1	1	1	6
NONE	OG0007521	1	1	1	1	1	1	6
NONE	OG0007522	1	1	1	1	1	1	6
NONE	OG0007523	1	1	1	1	1	1	6
NONE	OG0007524	1	1	1	1	1	1	6
NONE	OG0007525	1	1	1	1	1	1	6
NONE	OG0007526	1	1	1	1	1	1	6
NONE	OG0007527	1	1	1	1	1	1	6
NONE	OG0007528	1	1	1	1	1	1	6
NONE	OG0007529	1	1	1	1	1	1	6
NONE	OG0007530	1	1	1	1	1	1	6
NONE	OG0007531	2	1	1	1	0	1	6
NONE	OG0007532	1	1	1	1	1	1	6
NONE	OG0007533	1	1	1	1	1	1	6
NONE	OG0007534	1	1	1	1	1	1	6
NONE	OG0007535	1	1	1	1	1	1	6
NONE	OG0007536	1	1	1	1	1	1	6
NONE	OG0007537	1	1	1	1	1	1	6
NONE	OG0007538	1	1	1	1	1	1	6
NONE	OG0007539	1	1	1	1	1	1	6
NONE	OG0007540	1	1	1	1	1	1	6
NONE	OG0007541	1	1	1	1	1	1	6
NONE	OG0007542	1	1	1	1	1	1	6
NONE	OG0007543	1	1	1	1	1	1	6
NONE	OG0007544	1	1	1	1	1	1	6
NONE	OG0007545	1	1	1	1	1	1	6
NONE	OG0007546	1	1	1	1	1	1	6
NONE	OG0007547	1	1	1	1	1	1	6
NONE	OG0007548	1	1	1	1	1	1	6
NONE	OG0007549	1	1	1	1	1	1	6
NONE	OG0007550	1	0	2	1	1	1	6
NONE	OG0007551	1	1	1	1	1	1	6
NONE	OG0007552	2	0	2	2	0	0	6
NONE	OG0007553	1	1	1	1	1	1	6
NONE	OG0007554	1	1	1	1	1	1	6
NONE	OG0007555	1	1	1	1	1	1	6
NONE	OG0007556	1	1	1	1	1	1	6
NONE	OG0007557	1	1	1	1	1	1	6
NONE	OG0007558	1	1	1	1	1	1	6
NONE	OG0007559	1	1	1	1	1	1	6
NONE	OG0007560	1	1	1	1	1	1	6
NONE	OG0007561	1	1	1	1	1	1	6
NONE	OG0007562	1	0	1	2	1	1	6
NONE	OG0007563	1	1	1	1	1	1	6
NONE	OG0007564	1	1	1	1	1	1	6
NONE	OG0007565	1	1	1	1	1	1	6
NONE	OG0007566	1	1	1	1	1	1	6
NONE	OG0007567	1	1	1	1	1	1	6
NONE	OG0007568	1	1	1	1	1	1	6
NONE	OG0007569	1	1	1	1	1	1	6
NONE	OG0007570	1	1	1	1	1	1	6
NONE	OG0007571	1	1	1	1	1	1	6
NONE	OG0007572	1	1	1	1	1	1	6
NONE	OG0007573	1	1	1	1	1	1	6
NONE	OG0007574	1	1	1	1	1	1	6
NONE	OG0007575	1	1	1	1	1	1	6
NONE	OG0007576	1	1	1	1	1	1	6
NONE	OG0007577	1	1	1	1	1	1	6
NONE	OG0007578	1	1	1	1	1	1	6
NONE	OG0007579	1	1	1	1	1	1	6
NONE	OG0007580	1	1	1	1	1	1	6
NONE	OG0007581	1	1	1	1	1	1	6
NONE	OG0007582	1	1	1	1	1	1	6
NONE	OG0007583	1	1	1	1	1	1	6
NONE	OG0007584	1	1	1	1	1	1	6
NONE	OG0007585	1	1	1	1	1	1	6
NONE	OG0007586	1	1	1	1	1	1	6
NONE	OG0007587	1	1	1	0	2	1	6
NONE	OG0007588	1	1	1	1	1	1	6
NONE	OG0007589	1	0	1	2	0	2	6
NONE	OG0007590	1	0	1	2	1	1	6
NONE	OG0007591	1	1	1	1	1	1	6
NONE	OG0007592	1	0	1	1	1	2	6
NONE	OG0007593	1	1	1	1	1	1	6
NONE	OG0007594	1	1	1	1	1	1	6
NONE	OG0007595	1	1	1	1	1	1	6
NONE	OG0007596	1	1	1	1	1	1	6
NONE	OG0007597	1	1	1	1	1	1	6
NONE	OG0007598	1	1	1	1	1	1	6
NONE	OG0007599	1	1	1	1	1	1	6
NONE	OG0007600	1	1	1	1	1	1	6
NONE	OG0007601	1	1	1	1	1	1	6
NONE	OG0007602	1	1	1	1	1	1	6
NONE	OG0007603	1	1	1	1	1	1	6
NONE	OG0007604	1	1	1	1	1	1	6
NONE	OG0007605	1	1	1	1	1	1	6
NONE	OG0007606	1	1	1	1	1	1	6
NONE	OG0007607	1	1	1	1	1	1	6
NONE	OG0007608	1	1	1	1	1	1	6
NONE	OG0007609	2	0	2	1	0	1	6
NONE	OG0007610	1	1	1	1	1	1	6
NONE	OG0007611	1	1	1	1	1	1	6
NONE	OG0007612	1	1	1	1	1	1	6
NONE	OG0007613	1	1	1	1	1	1	6
NONE	OG0007614	1	1	1	1	1	1	6
NONE	OG0007615	1	1	1	1	1	1	6
NONE	OG0007616	1	1	1	1	1	1	6
NONE	OG0007617	1	1	1	1	1	1	6
NONE	OG0007618	1	1	1	1	1	1	6
NONE	OG0007619	1	1	1	1	1	1	6
NONE	OG0007620	1	1	1	1	1	1	6
NONE	OG0007621	1	1	1	1	1	1	6
NONE	OG0007622	1	1	1	1	1	1	6
NONE	OG0007623	1	1	1	1	1	1	6
NONE	OG0007624	1	1	1	1	1	1	6
NONE	OG0007625	1	0	3	0	0	2	6
NONE	OG0007626	1	1	1	1	1	1	6
NONE	OG0007627	1	1	1	1	1	1	6
NONE	OG0007628	1	1	1	1	1	1	6
NONE	OG0007629	1	1	1	1	1	1	6
NONE	OG0007630	1	1	1	2	0	1	6
NONE	OG0007631	1	1	1	1	1	1	6
NONE	OG0007632	1	1	1	1	1	1	6
NONE	OG0007633	1	1	1	1	1	1	6
NONE	OG0007634	1	1	1	1	1	1	6
NONE	OG0007635	1	1	1	1	1	1	6
NONE	OG0007636	1	1	1	1	1	1	6
NONE	OG0007637	1	1	1	1	1	1	6
NONE	OG0007638	1	1	1	1	1	1	6
NONE	OG0007639	1	1	1	1	1	1	6
NONE	OG0007640	1	1	1	1	1	1	6
NONE	OG0007641	1	1	1	1	1	1	6
NONE	OG0007642	1	1	1	1	1	1	6
NONE	OG0007643	1	1	1	1	1	1	6
NONE	OG0007644	1	1	1	1	1	1	6
NONE	OG0007645	1	1	1	1	1	1	6
NONE	OG0007646	1	1	1	1	1	1	6
NONE	OG0007647	1	1	1	1	1	1	6
NONE	OG0007648	1	1	1	1	1	1	6
NONE	OG0007649	1	1	1	1	1	1	6
NONE	OG0007650	1	1	1	1	1	1	6
NONE	OG0007651	1	1	1	1	1	1	6
NONE	OG0007652	1	1	1	1	1	1	6
NONE	OG0007653	1	1	1	1	1	1	6
NONE	OG0007654	1	1	1	1	1	1	6
NONE	OG0007655	1	1	1	1	1	1	6
NONE	OG0007656	1	1	1	1	1	1	6
NONE	OG0007657	1	1	1	1	1	1	6
NONE	OG0007658	1	1	1	1	1	1	6
NONE	OG0007659	1	1	1	1	1	1	6
NONE	OG0007660	1	1	1	1	1	1	6
NONE	OG0007661	1	1	1	1	1	1	6
NONE	OG0007662	2	0	2	1	0	1	6
NONE	OG0007663	1	1	1	1	1	1	6
NONE	OG0007664	1	0	2	1	1	1	6
NONE	OG0007665	1	1	1	1	1	1	6
NONE	OG0007666	1	1	1	1	1	1	6
NONE	OG0007667	1	1	1	1	1	1	6
NONE	OG0007668	1	1	1	1	1	1	6
NONE	OG0007669	1	1	1	1	1	1	6
NONE	OG0007670	1	1	1	1	1	1	6
NONE	OG0007671	1	1	1	1	1	1	6
NONE	OG0007672	1	1	1	1	1	1	6
NONE	OG0007673	1	1	1	1	1	1	6
NONE	OG0007674	1	1	1	1	1	1	6
NONE	OG0007675	1	1	1	1	1	1	6
NONE	OG0007676	1	1	1	1	1	1	6
NONE	OG0007677	1	1	1	1	1	1	6
NONE	OG0007678	1	1	1	1	1	1	6
NONE	OG0007679	1	1	1	1	1	1	6
NONE	OG0007680	1	1	1	1	1	1	6
NONE	OG0007681	1	1	1	1	1	1	6
NONE	OG0007682	1	1	1	1	1	1	6
NONE	OG0007683	1	1	1	2	0	1	6
NONE	OG0007684	1	1	1	1	1	1	6
NONE	OG0007685	1	1	1	1	1	1	6
NONE	OG0007686	1	1	1	1	1	1	6
NONE	OG0007687	1	1	1	1	1	1	6
NONE	OG0007688	1	1	1	1	1	1	6
NONE	OG0007689	1	1	1	1	1	1	6
NONE	OG0007690	1	1	1	1	1	1	6
NONE	OG0007691	1	1	1	1	1	1	6
NONE	OG0007692	1	1	1	1	1	1	6
NONE	OG0007693	1	1	1	1	1	1	6
NONE	OG0007694	1	1	1	1	1	1	6
NONE	OG0007695	1	1	1	1	1	1	6
NONE	OG0007696	1	1	1	1	1	1	6
NONE	OG0007697	1	1	1	1	1	1	6
NONE	OG0007698	1	1	1	1	1	1	6
NONE	OG0007699	1	1	1	1	1	1	6
NONE	OG0007700	1	0	1	1	2	1	6
NONE	OG0007701	1	1	1	1	1	1	6
NONE	OG0007702	1	1	1	1	1	1	6
NONE	OG0007703	1	1	1	1	1	1	6
NONE	OG0007704	1	1	1	1	1	1	6
NONE	OG0007705	1	1	1	1	1	1	6
NONE	OG0007706	1	1	1	1	1	1	6
NONE	OG0007707	1	1	1	1	1	1	6
NONE	OG0007708	1	1	1	1	1	1	6
NONE	OG0007709	1	1	1	1	1	1	6
NONE	OG0007710	1	1	1	1	1	1	6
NONE	OG0007711	1	1	1	1	1	1	6
NONE	OG0007712	1	1	1	1	1	1	6
NONE	OG0007713	1	0	1	2	1	1	6
NONE	OG0007714	1	1	1	1	1	1	6
NONE	OG0007715	1	1	1	1	1	1	6
NONE	OG0007716	1	1	1	1	1	1	6
NONE	OG0007717	1	1	1	1	1	1	6
NONE	OG0007718	1	1	1	1	1	1	6
NONE	OG0007719	1	1	1	1	1	1	6
NONE	OG0007720	1	1	1	1	1	1	6
NONE	OG0007721	1	1	1	1	1	1	6
NONE	OG0007722	1	1	1	1	1	1	6
NONE	OG0007723	1	1	1	1	1	1	6
NONE	OG0007724	1	1	1	1	1	1	6
NONE	OG0007725	1	1	1	1	1	1	6
NONE	OG0007726	1	1	1	1	1	1	6
NONE	OG0007727	1	0	1	1	2	1	6
NONE	OG0007728	1	1	1	1	1	1	6
NONE	OG0007729	1	1	1	1	1	1	6
NONE	OG0007730	1	1	1	1	1	1	6
NONE	OG0007731	1	1	1	1	1	1	6
NONE	OG0007732	1	1	1	1	1	1	6
NONE	OG0007733	1	1	1	1	1	1	6
NONE	OG0007734	1	1	1	1	1	1	6
NONE	OG0007735	1	1	1	1	1	1	6
NONE	OG0007736	1	1	1	1	1	1	6
NONE	OG0007737	1	1	1	1	1	1	6
NONE	OG0007738	1	1	1	1	1	1	6
NONE	OG0007739	1	1	1	1	1	1	6
NONE	OG0007740	1	1	1	1	1	1	6
NONE	OG0007741	1	1	1	1	1	1	6
NONE	OG0007742	1	1	1	1	1	1	6
NONE	OG0007743	1	1	1	1	1	1	6
NONE	OG0007744	1	1	1	1	1	1	6
NONE	OG0007745	1	0	2	1	1	1	6
NONE	OG0007746	1	1	1	1	1	1	6
NONE	OG0007747	1	1	1	1	1	1	6
NONE	OG0007748	1	1	1	1	1	1	6
NONE	OG0007749	1	1	1	1	1	1	6
NONE	OG0007750	1	1	1	1	1	1	6
NONE	OG0007751	1	1	1	1	1	1	6
NONE	OG0007752	1	1	1	1	1	1	6
NONE	OG0007753	1	1	1	1	1	1	6
NONE	OG0007754	1	1	1	1	1	1	6
NONE	OG0007755	1	1	1	1	1	1	6
NONE	OG0007756	1	1	1	1	1	1	6
NONE	OG0007757	1	1	1	1	1	1	6
NONE	OG0007758	1	1	1	1	1	1	6
NONE	OG0007759	1	1	1	1	1	1	6
NONE	OG0007760	1	1	1	1	1	1	6
NONE	OG0007761	1	1	1	1	1	1	6
NONE	OG0007762	1	1	1	1	1	1	6
NONE	OG0007763	1	1	1	1	1	1	6
NONE	OG0007764	1	1	1	1	1	1	6
NONE	OG0007765	1	1	1	1	1	1	6
NONE	OG0007766	1	1	1	1	1	1	6
NONE	OG0007767	1	1	1	1	1	1	6
NONE	OG0007768	1	1	1	1	1	1	6
NONE	OG0007769	1	1	1	1	1	1	6
NONE	OG0007770	1	1	1	1	1	1	6
NONE	OG0007771	1	1	1	1	1	1	6
NONE	OG0007772	1	1	1	1	1	1	6
NONE	OG0007773	1	1	1	1	1	1	6
NONE	OG0007774	1	1	1	1	1	1	6
NONE	OG0007775	1	1	1	1	1	1	6
NONE	OG0007776	1	1	1	1	1	1	6
NONE	OG0007777	1	1	1	1	1	1	6
NONE	OG0007778	1	1	1	1	1	1	6
NONE	OG0007779	1	1	1	1	1	1	6
NONE	OG0007780	1	1	1	1	1	1	6
NONE	OG0007781	1	1	1	1	1	1	6
NONE	OG0007782	1	1	1	1	1	1	6
NONE	OG0007783	1	1	1	1	1	1	6
NONE	OG0007784	1	1	1	1	1	1	6
NONE	OG0007785	1	1	1	1	1	1	6
NONE	OG0007786	1	1	1	1	1	1	6
NONE	OG0007787	1	1	2	1	0	1	6
NONE	OG0007788	1	0	2	1	1	1	6
NONE	OG0007789	1	1	2	1	0	1	6
NONE	OG0007790	1	0	2	1	1	1	6
NONE	OG0007791	1	1	1	1	1	1	6
NONE	OG0007792	1	1	1	1	1	1	6
NONE	OG0007793	1	1	1	1	1	1	6
NONE	OG0007794	1	1	1	1	1	1	6
NONE	OG0007795	1	1	1	1	1	1	6
NONE	OG0007796	1	1	2	1	0	1	6
NONE	OG0007797	1	1	1	1	1	1	6
NONE	OG0007798	1	1	1	1	1	1	6
NONE	OG0007799	1	1	1	1	1	1	6
NONE	OG0007800	1	1	1	1	1	1	6
NONE	OG0007801	1	1	1	1	1	1	6
NONE	OG0007802	1	1	1	1	1	1	6
NONE	OG0007803	1	1	1	1	1	1	6
NONE	OG0007804	1	1	1	1	1	1	6
NONE	OG0007805	1	1	1	1	1	1	6
NONE	OG0007806	1	1	1	1	1	1	6
NONE	OG0007807	1	1	1	1	1	1	6
NONE	OG0007808	1	1	1	1	1	1	6
NONE	OG0007809	1	1	1	1	1	1	6
NONE	OG0007810	1	1	1	1	1	1	6
NONE	OG0007811	1	1	1	1	1	1	6
NONE	OG0007812	1	1	1	1	1	1	6
NONE	OG0007813	1	1	1	1	1	1	6
NONE	OG0007814	1	1	1	1	1	1	6
NONE	OG0007815	1	1	1	1	1	1	6
NONE	OG0007816	1	1	1	1	1	1	6
NONE	OG0007817	1	1	1	1	1	1	6
NONE	OG0007818	1	1	1	1	1	1	6
NONE	OG0007819	1	1	1	1	1	1	6
NONE	OG0007820	1	1	1	1	1	1	6
NONE	OG0007821	1	1	1	1	1	1	6
NONE	OG0007822	1	1	1	1	1	1	6
NONE	OG0007823	1	1	1	1	1	1	6
NONE	OG0007824	1	1	1	1	1	1	6
NONE	OG0007825	1	1	1	1	1	1	6
NONE	OG0007826	1	0	2	1	1	1	6
NONE	OG0007827	1	1	1	1	1	1	6
NONE	OG0007828	1	1	1	1	1	1	6
NONE	OG0007829	1	1	1	1	1	1	6
NONE	OG0007830	1	1	1	1	1	1	6
NONE	OG0007831	1	1	1	1	1	1	6
NONE	OG0007832	1	1	1	1	1	1	6
NONE	OG0007833	1	1	1	1	1	1	6
NONE	OG0007834	1	0	3	1	0	1	6
NONE	OG0007835	1	0	3	1	0	1	6
NONE	OG0007836	1	1	1	1	1	1	6
NONE	OG0007837	1	1	2	0	1	1	6
NONE	OG0007838	1	1	1	1	1	1	6
NONE	OG0007839	1	1	1	1	1	1	6
NONE	OG0007840	1	1	1	1	1	1	6
NONE	OG0007841	1	0	3	1	0	1	6
NONE	OG0007842	1	1	1	1	1	1	6
NONE	OG0007843	1	1	1	1	1	1	6
NONE	OG0007844	1	1	1	1	1	1	6
NONE	OG0007845	1	1	1	1	1	1	6
NONE	OG0007846	1	1	1	1	1	1	6
NONE	OG0007847	1	1	1	1	1	1	6
NONE	OG0007848	1	1	1	1	1	1	6
NONE	OG0007849	1	1	1	1	1	1	6
NONE	OG0007850	1	1	1	1	1	1	6
NONE	OG0007851	1	1	1	1	1	1	6
NONE	OG0007852	1	1	1	1	1	1	6
NONE	OG0007853	1	1	1	1	1	1	6
NONE	OG0007854	1	1	1	1	1	1	6
NONE	OG0007855	1	0	2	1	1	1	6
NONE	OG0007856	1	1	2	1	1	0	6
NONE	OG0007857	1	1	2	1	0	1	6
NONE	OG0007858	1	1	1	1	1	1	6
NONE	OG0007859	1	1	1	1	1	1	6
NONE	OG0007860	1	1	1	1	1	1	6
NONE	OG0007861	1	1	1	1	1	1	6
NONE	OG0007862	1	1	1	1	1	1	6
NONE	OG0007863	1	1	1	1	1	1	6
NONE	OG0007864	1	1	1	1	1	1	6
NONE	OG0007865	1	1	1	1	1	1	6
NONE	OG0007866	1	1	1	1	1	1	6
NONE	OG0007867	1	1	1	1	1	1	6
NONE	OG0007868	1	1	1	1	1	1	6
NONE	OG0007869	1	1	1	1	1	1	6
NONE	OG0007870	1	1	1	1	1	1	6
NONE	OG0007871	1	1	1	1	1	1	6
NONE	OG0007872	1	1	1	1	1	1	6
NONE	OG0007873	1	1	1	1	1	1	6
NONE	OG0007874	1	1	1	1	1	1	6
NONE	OG0007875	1	1	1	1	1	1	6
NONE	OG0007876	1	1	1	1	1	1	6
NONE	OG0007877	1	1	1	1	1	1	6
NONE	OG0007878	1	1	1	1	1	1	6
NONE	OG0007879	1	1	1	1	1	1	6
NONE	OG0007880	1	1	1	1	1	1	6
NONE	OG0007881	1	1	1	1	1	1	6
NONE	OG0007882	2	1	1	1	0	1	6
NONE	OG0007883	1	1	1	1	1	1	6
NONE	OG0007884	1	1	1	1	1	1	6
NONE	OG0007885	1	1	1	1	1	1	6
NONE	OG0007886	1	1	1	1	1	1	6
NONE	OG0007887	1	0	2	1	1	1	6
NONE	OG0007888	2	0	1	1	0	2	6
NONE	OG0007889	1	1	1	1	1	1	6
NONE	OG0007890	1	1	1	1	1	1	6
NONE	OG0007891	1	1	1	1	1	1	6
NONE	OG0007892	1	1	1	1	1	1	6
NONE	OG0007893	1	1	1	1	1	1	6
NONE	OG0007894	1	1	1	1	1	1	6
NONE	OG0007895	1	1	1	1	1	1	6
NONE	OG0007896	1	1	1	1	1	1	6
NONE	OG0007897	1	1	1	1	1	1	6
NONE	OG0007898	1	1	1	1	1	1	6
NONE	OG0007899	1	1	1	1	1	1	6
NONE	OG0007900	1	1	1	1	1	1	6
NONE	OG0007901	1	1	1	1	1	1	6
NONE	OG0007902	1	1	1	1	1	1	6
NONE	OG0007903	1	1	1	1	1	1	6
NONE	OG0007904	1	1	1	1	1	1	6
NONE	OG0007905	1	1	1	1	1	1	6
NONE	OG0007906	1	1	1	1	1	1	6
NONE	OG0007907	1	1	1	1	1	1	6
NONE	OG0007908	1	1	1	1	1	1	6
NONE	OG0007909	1	1	1	1	1	1	6
NONE	OG0007910	1	1	1	1	1	1	6
NONE	OG0007911	1	1	1	1	1	1	6
NONE	OG0007912	1	1	1	1	1	1	6
NONE	OG0007913	1	1	1	1	1	1	6
NONE	OG0007914	1	1	1	1	1	1	6
NONE	OG0007915	1	1	1	1	1	1	6
NONE	OG0007916	1	1	1	1	1	1	6
NONE	OG0007917	1	1	1	1	1	1	6
NONE	OG0007918	1	1	1	1	1	1	6
NONE	OG0007919	1	1	1	1	1	1	6
NONE	OG0007920	1	1	1	1	1	1	6
NONE	OG0007921	1	1	1	1	1	1	6
NONE	OG0007922	1	1	1	1	1	1	6
NONE	OG0007923	1	1	1	1	1	1	6
NONE	OG0007924	1	1	1	1	1	1	6
NONE	OG0007925	1	0	3	1	0	1	6
NONE	OG0007926	1	1	1	1	1	1	6
NONE	OG0007927	2	0	1	1	1	1	6
NONE	OG0007928	1	1	1	1	1	1	6
NONE	OG0007929	2	0	1	1	1	1	6
NONE	OG0007930	1	1	1	1	1	1	6
NONE	OG0007931	1	1	1	1	1	1	6
NONE	OG0007932	1	1	2	2	0	0	6
NONE	OG0007933	1	1	1	1	1	1	6
NONE	OG0007934	1	1	1	1	1	1	6
NONE	OG0007935	1	1	1	1	1	1	6
NONE	OG0007936	1	1	1	1	1	1	6
NONE	OG0007937	1	1	1	1	1	1	6
NONE	OG0007938	1	1	1	1	1	1	6
NONE	OG0007939	1	1	1	1	1	1	6
NONE	OG0007940	1	1	1	1	1	1	6
NONE	OG0007941	1	1	1	1	1	1	6
NONE	OG0007942	1	1	1	1	1	1	6
NONE	OG0007943	1	1	1	1	1	1	6
NONE	OG0007944	1	1	1	1	1	1	6
NONE	OG0007945	1	1	1	1	1	1	6
NONE	OG0007946	1	1	1	1	1	1	6
NONE	OG0007947	1	1	1	1	1	1	6
NONE	OG0007948	1	1	1	1	1	1	6
NONE	OG0007949	1	1	1	1	1	1	6
NONE	OG0007950	2	0	1	1	1	1	6
NONE	OG0007951	1	1	1	1	1	1	6
NONE	OG0007952	1	1	1	1	1	1	6
NONE	OG0007953	1	2	1	1	0	1	6
NONE	OG0007954	1	1	1	1	1	1	6
NONE	OG0007955	1	1	1	1	1	1	6
NONE	OG0007956	1	1	1	1	1	1	6
NONE	OG0007957	1	1	1	1	1	1	6
NONE	OG0007958	1	1	1	1	1	1	6
NONE	OG0007959	1	1	1	1	1	1	6
NONE	OG0007960	1	1	1	1	1	1	6
NONE	OG0007961	1	1	1	1	1	1	6
NONE	OG0007962	1	1	1	1	1	1	6
NONE	OG0007963	1	1	1	1	1	1	6
NONE	OG0007964	1	1	1	1	1	1	6
NONE	OG0007965	1	1	1	1	1	1	6
NONE	OG0007966	1	1	1	1	1	1	6
NONE	OG0007967	2	1	1	1	0	1	6
NONE	OG0007968	1	1	1	1	1	1	6
NONE	OG0007969	1	1	1	1	1	1	6
NONE	OG0007970	1	1	1	1	1	1	6
NONE	OG0007971	1	1	1	1	1	1	6
NONE	OG0007972	1	1	2	1	0	1	6
NONE	OG0007973	1	1	1	1	1	1	6
NONE	OG0007974	1	1	1	1	1	1	6
NONE	OG0007975	1	1	1	1	1	1	6
NONE	OG0007976	2	0	1	1	1	1	6
NONE	OG0007977	2	1	1	1	0	1	6
NONE	OG0007978	1	1	1	1	1	1	6
NONE	OG0007979	1	0	2	0	0	3	6
NONE	OG0007980	1	1	1	1	1	1	6
NONE	OG0007981	1	1	1	1	1	1	6
NONE	OG0007982	1	1	1	1	1	1	6
NONE	OG0007983	1	1	1	1	1	1	6
NONE	OG0007984	1	1	1	1	1	1	6
NONE	OG0007985	1	1	1	1	1	1	6
NONE	OG0007986	1	1	1	1	1	1	6
NONE	OG0007987	2	1	1	1	0	1	6
NONE	OG0007988	1	1	1	1	1	1	6
NONE	OG0007989	1	1	1	1	1	1	6
NONE	OG0007990	1	1	1	1	1	1	6
NONE	OG0007991	1	1	1	1	1	1	6
NONE	OG0007992	1	1	1	1	1	1	6
NONE	OG0007993	2	0	1	1	1	1	6
NONE	OG0007994	1	1	1	1	1	1	6
NONE	OG0007995	1	1	1	1	1	1	6
NONE	OG0007996	1	1	2	1	0	1	6
NONE	OG0007997	1	0	1	3	0	1	6
NONE	OG0007998	1	1	1	1	1	1	6
NONE	OG0007999	1	1	1	1	1	1	6
NONE	OG0008000	1	1	1	1	1	1	6
NONE	OG0008001	1	1	1	1	1	1	6
NONE	OG0008002	1	1	1	1	1	1	6
NONE	OG0008003	1	1	1	1	1	1	6
NONE	OG0008004	1	1	1	1	1	1	6
NONE	OG0008005	1	1	1	1	1	1	6
NONE	OG0008006	1	1	1	1	1	1	6
NONE	OG0008007	1	1	1	1	1	1	6
NONE	OG0008008	1	1	1	1	1	1	6
NONE	OG0008009	1	1	1	1	1	1	6
NONE	OG0008010	1	1	1	1	1	1	6
NONE	OG0008011	1	1	1	1	1	1	6
NONE	OG0008012	1	1	1	1	1	1	6
NONE	OG0008013	1	1	1	1	1	1	6
NONE	OG0008014	1	1	1	1	1	1	6
NONE	OG0008015	1	1	1	1	1	1	6
NONE	OG0008016	1	1	1	1	1	1	6
NONE	OG0008017	1	1	1	1	1	1	6
NONE	OG0008018	1	1	1	1	1	1	6
NONE	OG0008019	1	1	1	1	1	1	6
NONE	OG0008020	1	1	1	1	1	1	6
NONE	OG0008021	1	0	2	2	0	1	6
NONE	OG0008022	1	1	1	1	1	1	6
NONE	OG0008023	1	1	1	1	1	1	6
NONE	OG0008024	1	1	1	1	1	1	6
NONE	OG0008025	1	1	1	1	1	1	6
NONE	OG0008026	1	1	1	1	1	1	6
NONE	OG0008027	1	1	1	1	1	1	6
NONE	OG0008028	1	1	1	1	1	1	6
NONE	OG0008029	1	1	1	1	1	1	6
NONE	OG0008030	1	1	1	1	1	1	6
NONE	OG0008031	1	1	1	1	1	1	6
NONE	OG0008032	1	1	1	1	1	1	6
NONE	OG0008033	1	1	1	1	1	1	6
NONE	OG0008034	1	1	1	1	1	1	6
NONE	OG0008035	1	1	1	1	1	1	6
NONE	OG0008036	1	1	1	1	1	1	6
NONE	OG0008037	1	1	1	1	1	1	6
NONE	OG0008038	1	0	1	2	1	1	6
NONE	OG0008039	1	1	1	1	1	1	6
NONE	OG0008040	1	1	1	1	1	1	6
NONE	OG0008041	1	1	1	1	1	1	6
NONE	OG0008042	1	1	1	1	1	1	6
NONE	OG0008043	1	1	1	1	1	1	6
NONE	OG0008044	1	1	1	1	1	1	6
NONE	OG0008045	1	1	1	1	1	1	6
NONE	OG0008046	1	1	1	1	1	1	6
NONE	OG0008047	2	0	1	1	1	1	6
NONE	OG0008048	1	1	1	1	1	1	6
NONE	OG0008049	1	1	1	1	1	1	6
NONE	OG0008050	1	1	1	1	1	1	6
NONE	OG0008051	1	1	1	1	1	1	6
NONE	OG0008052	1	1	1	1	1	1	6
NONE	OG0008053	1	1	1	1	1	1	6
NONE	OG0008054	1	1	1	1	1	1	6
NONE	OG0008055	1	1	1	1	1	1	6
NONE	OG0008056	1	1	1	1	1	1	6
NONE	OG0008057	1	1	2	1	0	1	6
NONE	OG0008058	2	0	1	1	0	2	6
NONE	OG0008059	1	1	1	1	1	1	6
NONE	OG0008060	1	1	1	2	0	1	6
NONE	OG0008061	1	1	1	1	1	1	6
NONE	OG0008062	1	1	1	1	1	1	6
NONE	OG0008063	1	1	1	1	1	1	6
NONE	OG0008064	1	1	1	1	1	1	6
NONE	OG0008065	1	1	1	1	1	1	6
NONE	OG0008066	1	1	1	1	1	1	6
NONE	OG0008067	1	1	1	1	1	1	6
NONE	OG0008068	1	1	1	1	1	1	6
NONE	OG0008069	1	0	1	2	1	1	6
NONE	OG0008070	1	1	1	1	1	1	6
NONE	OG0008071	1	1	1	1	1	1	6
NONE	OG0008072	1	1	1	1	1	1	6
NONE	OG0008073	1	1	1	1	1	1	6
NONE	OG0008074	1	1	1	1	1	1	6
NONE	OG0008075	1	1	1	1	1	1	6
NONE	OG0008076	1	1	1	1	1	1	6
NONE	OG0008077	1	1	1	1	1	1	6
NONE	OG0008078	1	1	1	1	1	1	6
NONE	OG0008079	1	0	1	0	0	4	6
NONE	OG0008080	1	1	0	3	0	1	6
NONE	OG0008081	1	1	1	1	1	1	6
NONE	OG0008082	1	1	1	1	1	1	6
NONE	OG0008083	1	1	1	1	1	1	6
NONE	OG0008084	1	1	1	1	1	1	6
NONE	OG0008085	1	1	1	1	1	1	6
NONE	OG0008086	1	1	1	1	1	1	6
NONE	OG0008087	1	1	1	1	1	1	6
NONE	OG0008088	1	1	1	1	1	1	6
NONE	OG0008089	1	1	1	1	1	1	6
NONE	OG0008090	1	1	1	1	1	1	6
NONE	OG0008091	1	1	1	1	1	1	6
NONE	OG0008092	1	1	1	1	1	1	6
NONE	OG0008093	1	1	1	1	1	1	6
NONE	OG0008094	1	1	1	1	1	1	6
NONE	OG0008095	1	1	1	1	1	1	6
NONE	OG0008096	1	1	1	1	1	1	6
NONE	OG0008097	1	1	1	1	1	1	6
NONE	OG0008098	1	0	1	3	0	1	6
NONE	OG0008099	1	1	1	1	1	1	6
NONE	OG0008100	1	1	1	1	1	1	6
NONE	OG0008101	1	1	1	1	1	1	6
NONE	OG0008102	2	1	1	1	1	0	6
NONE	OG0008103	2	1	1	1	1	0	6
NONE	OG0008104	1	1	1	1	1	1	6
NONE	OG0008105	1	1	1	1	1	1	6
NONE	OG0008106	1	1	1	1	1	1	6
NONE	OG0008107	1	1	1	1	1	1	6
NONE	OG0008108	1	1	1	1	1	1	6
NONE	OG0008109	1	1	1	1	1	1	6
NONE	OG0008110	1	1	1	1	1	1	6
NONE	OG0008111	1	1	1	1	1	1	6
NONE	OG0008112	1	1	1	1	1	1	6
NONE	OG0008113	1	1	1	1	1	1	6
NONE	OG0008114	1	1	1	1	1	1	6
NONE	OG0008115	1	1	1	1	1	1	6
NONE	OG0008116	1	1	1	1	1	1	6
NONE	OG0008117	1	1	1	1	1	1	6
NONE	OG0008118	1	1	1	1	1	1	6
NONE	OG0008119	1	1	1	1	1	1	6
NONE	OG0008120	1	1	1	1	1	1	6
NONE	OG0008121	1	1	1	1	1	1	6
NONE	OG0008122	1	1	1	1	1	1	6
NONE	OG0008123	1	1	1	1	1	1	6
NONE	OG0008124	1	1	1	1	1	1	6
NONE	OG0008125	1	1	1	1	1	1	6
NONE	OG0008126	1	1	1	1	1	1	6
NONE	OG0008127	1	1	1	1	1	1	6
NONE	OG0008128	1	1	1	1	1	1	6
NONE	OG0008129	1	1	1	1	1	1	6
NONE	OG0008130	1	1	1	1	1	1	6
NONE	OG0008131	1	1	1	1	1	1	6
NONE	OG0008132	1	1	1	1	1	1	6
NONE	OG0008133	1	0	1	2	1	1	6
NONE	OG0008134	1	1	1	1	1	1	6
NONE	OG0008135	2	0	1	1	1	1	6
NONE	OG0008136	1	1	1	1	1	1	6
NONE	OG0008137	1	1	1	1	1	1	6
NONE	OG0008138	1	1	1	1	1	1	6
NONE	OG0008139	1	1	1	1	1	1	6
NONE	OG0008140	1	1	1	1	1	1	6
NONE	OG0008141	1	1	1	1	1	1	6
NONE	OG0008142	1	1	1	1	1	1	6
NONE	OG0008143	1	1	1	1	1	1	6
NONE	OG0008144	1	1	1	1	1	1	6
NONE	OG0008145	1	1	1	1	1	1	6
NONE	OG0008146	1	1	1	1	1	1	6
NONE	OG0008147	2	1	0	1	1	1	6
NONE	OG0008148	1	1	1	1	1	1	6
NONE	OG0008149	1	1	1	1	1	1	6
NONE	OG0008150	1	1	1	1	1	1	6
NONE	OG0008151	1	1	1	1	1	1	6
NONE	OG0008152	1	1	1	1	1	1	6
NONE	OG0008153	1	1	1	1	1	1	6
NONE	OG0008154	1	1	1	1	1	1	6
NONE	OG0008155	1	1	1	1	1	1	6
NONE	OG0008156	1	1	1	1	1	1	6
NONE	OG0008157	1	1	1	1	1	1	6
NONE	OG0008158	1	1	1	1	1	1	6
NONE	OG0008159	1	1	1	1	1	1	6
NONE	OG0008160	1	1	1	1	1	1	6
NONE	OG0008161	1	1	1	1	1	1	6
NONE	OG0008162	1	1	1	1	1	1	6
NONE	OG0008163	1	1	1	1	1	1	6
NONE	OG0008164	1	1	1	1	1	1	6
NONE	OG0008165	1	1	1	1	1	1	6
NONE	OG0008166	1	1	1	1	1	1	6
NONE	OG0008167	1	1	1	1	1	1	6
NONE	OG0008168	2	0	1	1	1	1	6
NONE	OG0008169	2	0	1	1	1	1	6
NONE	OG0008170	2	0	1	1	1	1	6
NONE	OG0008171	1	1	1	1	1	1	6
NONE	OG0008172	1	1	1	1	1	1	6
NONE	OG0008173	1	1	1	1	1	1	6
NONE	OG0008174	1	1	1	1	1	1	6
NONE	OG0008175	1	1	1	1	1	1	6
NONE	OG0008176	1	1	1	1	1	1	6
NONE	OG0008177	1	1	1	1	1	1	6
NONE	OG0008178	1	1	1	1	1	1	6
NONE	OG0008179	1	1	1	1	1	1	6
NONE	OG0008180	1	1	1	1	1	1	6
NONE	OG0008181	1	1	1	1	1	1	6
NONE	OG0008182	1	1	1	1	1	1	6
NONE	OG0008183	1	1	1	1	1	1	6
NONE	OG0008184	1	1	1	1	1	1	6
NONE	OG0008185	1	1	1	1	1	1	6
NONE	OG0008186	1	1	1	1	1	1	6
NONE	OG0008187	1	1	1	1	1	1	6
NONE	OG0008188	1	1	1	1	1	1	6
NONE	OG0008189	1	1	1	1	1	1	6
NONE	OG0008190	1	1	1	1	1	1	6
NONE	OG0008191	1	1	1	1	1	1	6
NONE	OG0008192	1	1	1	1	1	1	6
NONE	OG0008193	1	1	1	1	1	1	6
NONE	OG0008194	1	1	1	1	1	1	6
NONE	OG0008195	1	1	1	1	1	1	6
NONE	OG0008196	1	1	1	1	1	1	6
NONE	OG0008197	1	1	1	1	1	1	6
NONE	OG0008198	1	1	1	1	1	1	6
NONE	OG0008199	1	1	1	1	1	1	6
NONE	OG0008200	1	1	1	1	1	1	6
NONE	OG0008201	1	1	1	1	1	1	6
NONE	OG0008202	1	1	1	1	1	1	6
NONE	OG0008203	1	1	1	1	1	1	6
NONE	OG0008204	1	1	1	1	1	1	6
NONE	OG0008205	1	1	1	1	1	1	6
NONE	OG0008206	1	1	1	1	1	1	6
NONE	OG0008207	1	1	1	1	1	1	6
NONE	OG0008208	1	1	1	1	1	1	6
NONE	OG0008209	1	1	1	1	1	1	6
NONE	OG0008210	1	1	1	1	1	1	6
NONE	OG0008211	1	1	1	1	1	1	6
NONE	OG0008212	1	1	1	1	1	1	6
NONE	OG0008213	1	1	1	1	1	1	6
NONE	OG0008214	1	1	1	1	1	1	6
NONE	OG0008215	1	1	1	1	1	1	6
NONE	OG0008216	1	1	1	1	1	1	6
NONE	OG0008217	1	1	1	1	1	1	6
NONE	OG0008218	1	1	1	1	1	1	6
NONE	OG0008219	1	1	1	1	1	1	6
NONE	OG0008220	1	1	1	1	1	1	6
NONE	OG0008221	1	1	1	1	1	1	6
NONE	OG0008222	1	1	1	1	1	1	6
NONE	OG0008223	1	1	1	1	1	1	6
NONE	OG0008224	1	1	1	1	1	1	6
NONE	OG0008225	1	1	1	1	1	1	6
NONE	OG0008226	1	1	1	1	1	1	6
NONE	OG0008227	1	1	1	1	1	1	6
NONE	OG0008228	1	1	1	1	1	1	6
NONE	OG0008229	1	1	1	1	1	1	6
NONE	OG0008230	2	0	3	1	0	0	6
NONE	OG0008231	1	1	1	1	1	1	6
NONE	OG0008232	1	1	1	1	1	1	6
NONE	OG0008233	1	1	1	1	1	1	6
NONE	OG0008234	1	1	1	1	1	1	6
NONE	OG0008235	1	1	1	1	1	1	6
NONE	OG0008236	1	1	1	1	1	1	6
NONE	OG0008237	1	1	1	1	1	1	6
NONE	OG0008238	1	1	1	1	1	1	6
NONE	OG0008239	1	1	1	1	1	1	6
NONE	OG0008240	1	1	1	1	1	1	6
NONE	OG0008241	1	1	1	1	1	1	6
NONE	OG0008242	1	1	1	1	1	1	6
NONE	OG0008243	1	1	1	1	1	1	6
NONE	OG0008244	1	1	1	1	1	1	6
NONE	OG0008245	1	1	1	1	1	1	6
NONE	OG0008246	1	1	1	1	1	1	6
NONE	OG0008247	1	1	1	1	1	1	6
NONE	OG0008248	1	1	1	1	1	1	6
NONE	OG0008249	1	1	1	1	1	1	6
NONE	OG0008250	1	1	1	1	1	1	6
NONE	OG0008251	1	1	1	1	1	1	6
NONE	OG0008252	1	1	1	1	1	1	6
NONE	OG0008253	1	1	1	1	1	1	6
NONE	OG0008254	1	1	1	1	1	1	6
NONE	OG0008255	1	1	1	1	1	1	6
NONE	OG0008256	1	1	1	1	1	1	6
NONE	OG0008257	1	1	1	1	1	1	6
NONE	OG0008258	1	1	1	1	1	1	6
NONE	OG0008259	1	1	1	1	1	1	6
NONE	OG0008260	1	0	1	3	0	1	6
NONE	OG0008261	1	1	1	1	1	1	6
NONE	OG0008262	1	1	1	1	1	1	6
NONE	OG0008263	1	1	1	1	1	1	6
NONE	OG0008264	1	1	1	1	1	1	6
NONE	OG0008265	1	1	1	1	1	1	6
NONE	OG0008266	1	1	1	1	1	1	6
NONE	OG0008267	1	1	1	1	1	1	6
NONE	OG0008268	1	1	1	1	1	1	6
NONE	OG0008269	1	1	1	1	1	1	6
NONE	OG0008270	1	1	1	1	1	1	6
NONE	OG0008271	1	1	1	1	1	1	6
NONE	OG0008272	1	1	1	1	1	1	6
NONE	OG0008273	1	1	1	1	1	1	6
NONE	OG0008274	1	1	1	1	1	1	6
NONE	OG0008275	1	1	1	1	1	1	6
NONE	OG0008276	1	1	1	1	1	1	6
NONE	OG0008277	1	1	1	1	1	1	6
NONE	OG0008278	1	1	1	1	1	1	6
NONE	OG0008279	1	1	1	1	1	1	6
NONE	OG0008280	1	1	1	1	1	1	6
NONE	OG0008281	1	1	1	1	1	1	6
NONE	OG0008282	1	1	1	1	1	1	6
NONE	OG0008283	1	1	1	1	1	1	6
NONE	OG0008284	1	1	1	1	1	1	6
NONE	OG0008285	1	1	1	2	0	1	6
NONE	OG0008286	1	1	1	1	1	1	6
NONE	OG0008287	1	2	1	1	0	1	6
NONE	OG0008288	1	1	1	1	1	1	6
NONE	OG0008289	1	1	1	1	1	1	6
NONE	OG0008290	1	1	1	1	1	1	6
NONE	OG0008291	1	1	1	1	1	1	6
NONE	OG0008292	1	1	1	1	1	1	6
NONE	OG0008293	1	1	1	1	1	1	6
NONE	OG0008294	1	1	1	1	1	1	6
NONE	OG0008295	1	1	1	1	1	1	6
NONE	OG0008296	1	1	1	1	1	1	6
NONE	OG0008297	1	1	1	1	1	1	6
NONE	OG0008298	1	1	1	1	0	2	6
NONE	OG0008299	1	1	1	1	1	1	6
NONE	OG0008300	1	1	1	1	1	1	6
NONE	OG0008301	1	1	1	1	1	1	6
NONE	OG0008302	1	1	1	1	1	1	6
NONE	OG0008303	1	1	1	1	1	1	6
NONE	OG0008304	1	1	1	1	1	1	6
NONE	OG0008305	1	1	1	1	1	1	6
NONE	OG0008306	1	1	1	1	1	1	6
NONE	OG0008307	1	1	1	1	1	1	6
NONE	OG0008308	1	1	1	1	1	1	6
NONE	OG0008309	1	1	1	1	1	1	6
NONE	OG0008310	1	1	1	1	1	1	6
NONE	OG0008311	1	1	1	1	1	1	6
NONE	OG0008312	1	1	1	1	1	1	6
NONE	OG0008313	1	1	1	1	1	1	6
NONE	OG0008314	1	1	1	1	1	1	6
NONE	OG0008315	1	1	1	1	1	1	6
NONE	OG0008316	1	1	1	1	1	1	6
NONE	OG0008317	1	1	1	1	1	1	6
NONE	OG0008318	1	1	1	1	1	1	6
NONE	OG0008319	1	1	1	1	1	1	6
NONE	OG0008320	1	1	1	1	1	1	6
NONE	OG0008321	1	1	1	1	1	1	6
NONE	OG0008322	1	0	1	2	1	1	6
NONE	OG0008323	1	1	1	1	1	1	6
NONE	OG0008324	1	1	1	1	1	1	6
NONE	OG0008325	1	1	1	1	1	1	6
NONE	OG0008326	1	1	1	1	1	1	6
NONE	OG0008327	1	1	1	1	1	1	6
NONE	OG0008328	1	1	1	1	1	1	6
NONE	OG0008329	1	1	1	1	1	1	6
NONE	OG0008330	1	1	1	1	1	1	6
NONE	OG0008331	1	1	1	1	1	1	6
NONE	OG0008332	1	1	1	1	1	1	6
NONE	OG0008333	1	1	1	1	1	1	6
NONE	OG0008334	1	1	1	1	1	1	6
NONE	OG0008335	1	1	1	1	1	1	6
NONE	OG0008336	1	1	1	1	1	1	6
NONE	OG0008337	1	1	1	1	1	1	6
NONE	OG0008338	1	1	1	1	1	1	6
NONE	OG0008339	1	1	1	1	1	1	6
NONE	OG0008340	1	1	1	1	1	1	6
NONE	OG0008341	1	1	1	1	1	1	6
NONE	OG0008342	1	1	1	1	1	1	6
NONE	OG0008343	1	1	1	1	1	1	6
NONE	OG0008344	1	1	1	1	1	1	6
NONE	OG0008345	1	1	1	1	1	1	6
NONE	OG0008346	1	1	1	1	1	1	6
NONE	OG0008347	1	1	1	1	1	1	6
NONE	OG0008348	1	1	1	1	1	1	6
NONE	OG0008349	1	1	1	1	1	1	6
NONE	OG0008350	2	1	1	1	0	1	6
NONE	OG0008351	1	1	1	1	1	1	6
NONE	OG0008352	1	1	1	1	1	1	6
NONE	OG0008353	1	1	1	1	1	1	6
NONE	OG0008354	2	1	1	1	0	1	6
NONE	OG0008355	1	1	1	1	1	1	6
NONE	OG0008356	1	1	1	1	1	1	6
NONE	OG0008357	1	1	1	1	1	1	6
NONE	OG0008358	1	1	1	1	1	1	6
NONE	OG0008359	1	1	1	1	1	1	6
NONE	OG0008360	1	1	1	1	1	1	6
NONE	OG0008361	1	1	1	1	1	1	6
NONE	OG0008362	1	1	1	1	1	1	6
NONE	OG0008363	1	1	1	1	1	1	6
NONE	OG0008364	1	1	1	1	1	1	6
NONE	OG0008365	1	1	1	1	1	1	6
NONE	OG0008366	1	1	1	1	1	1	6
NONE	OG0008367	1	0	1	2	1	1	6
NONE	OG0008368	1	1	1	1	1	1	6
NONE	OG0008369	1	1	1	1	1	1	6
NONE	OG0008370	1	1	1	1	1	1	6
NONE	OG0008371	1	1	1	1	1	1	6
NONE	OG0008372	1	1	1	1	1	1	6
NONE	OG0008373	1	1	1	1	1	1	6
NONE	OG0008374	1	1	1	1	1	1	6
NONE	OG0008375	1	1	1	1	1	1	6
NONE	OG0008376	1	1	1	1	1	1	6
NONE	OG0008377	1	1	1	1	1	1	6
NONE	OG0008378	1	1	1	1	1	1	6
NONE	OG0008379	1	1	1	1	1	1	6
NONE	OG0008380	1	1	1	1	1	1	6
NONE	OG0008381	1	1	1	1	1	1	6
NONE	OG0008382	1	1	1	1	1	1	6
NONE	OG0008383	1	1	1	1	1	1	6
NONE	OG0008384	1	1	1	1	1	1	6
NONE	OG0008385	1	1	1	1	1	1	6
NONE	OG0008386	1	0	2	1	1	1	6
NONE	OG0008387	1	1	1	1	1	1	6
NONE	OG0008388	1	1	1	1	1	1	6
NONE	OG0008389	1	1	1	1	1	1	6
NONE	OG0008390	1	1	2	1	0	1	6
NONE	OG0008391	1	1	1	1	1	1	6
NONE	OG0008392	1	1	1	1	1	1	6
NONE	OG0008393	1	1	1	1	1	1	6
NONE	OG0008394	1	1	1	1	1	1	6
NONE	OG0008395	1	1	1	1	1	1	6
NONE	OG0008396	1	1	1	1	1	1	6
NONE	OG0008397	1	1	1	1	1	1	6
NONE	OG0008398	1	1	1	1	1	1	6
NONE	OG0008399	1	1	1	1	1	1	6
NONE	OG0008400	1	1	1	1	1	1	6
NONE	OG0008401	1	1	1	1	1	1	6
NONE	OG0008402	1	1	1	1	1	1	6
NONE	OG0008403	1	1	1	1	1	1	6
NONE	OG0008404	1	1	1	1	1	1	6
NONE	OG0008405	1	1	1	1	1	1	6
NONE	OG0008406	1	1	1	1	1	1	6
NONE	OG0008407	1	1	1	1	1	1	6
NONE	OG0008408	1	1	1	1	1	1	6
NONE	OG0008409	1	1	1	1	1	1	6
NONE	OG0008410	1	1	1	1	1	1	6
NONE	OG0008411	1	1	1	1	1	1	6
NONE	OG0008412	1	1	1	1	1	1	6
NONE	OG0008413	1	1	1	1	1	1	6
NONE	OG0008414	1	1	1	1	1	1	6
NONE	OG0008415	1	1	1	1	1	1	6
NONE	OG0008416	1	1	1	1	1	1	6
NONE	OG0008417	1	1	1	1	1	1	6
NONE	OG0008418	1	1	1	1	1	1	6
NONE	OG0008419	1	1	1	1	1	1	6
NONE	OG0008420	1	1	1	1	1	1	6
NONE	OG0008421	1	1	1	1	1	1	6
NONE	OG0008422	1	1	1	1	1	1	6
NONE	OG0008423	1	1	1	1	1	1	6
NONE	OG0008424	1	1	1	1	1	1	6
NONE	OG0008425	1	1	1	1	1	1	6
NONE	OG0008426	1	1	1	1	1	1	6
NONE	OG0008427	1	1	1	1	1	1	6
NONE	OG0008428	1	1	1	1	1	1	6
NONE	OG0008429	1	1	1	1	1	1	6
NONE	OG0008430	1	1	1	1	1	1	6
NONE	OG0008431	1	1	1	1	1	1	6
NONE	OG0008432	1	1	1	1	1	1	6
NONE	OG0008433	1	1	1	1	1	1	6
NONE	OG0008434	1	1	1	1	1	1	6
NONE	OG0008435	1	1	1	1	1	1	6
NONE	OG0008436	1	1	1	1	1	1	6
NONE	OG0008437	1	1	1	1	1	1	6
NONE	OG0008438	1	1	1	2	0	1	6
NONE	OG0008439	1	1	1	1	1	1	6
NONE	OG0008440	1	1	1	1	1	1	6
NONE	OG0008441	1	0	1	2	1	1	6
NONE	OG0008442	1	1	1	1	1	1	6
NONE	OG0008443	1	1	1	1	1	1	6
NONE	OG0008444	1	1	1	1	1	1	6
NONE	OG0008445	1	1	1	1	1	1	6
NONE	OG0008446	1	1	1	1	1	1	6
NONE	OG0008447	1	1	1	1	1	1	6
NONE	OG0008448	1	1	1	1	1	1	6
NONE	OG0008449	1	1	1	1	1	1	6
NONE	OG0008450	1	1	1	1	1	1	6
NONE	OG0008451	1	0	1	1	2	1	6
NONE	OG0008452	1	1	1	1	1	1	6
NONE	OG0008453	1	1	1	1	1	1	6
NONE	OG0008454	1	1	1	1	1	1	6
NONE	OG0008455	1	1	1	1	1	1	6
NONE	OG0008456	1	1	1	1	1	1	6
NONE	OG0008457	1	1	1	1	1	1	6
NONE	OG0008458	1	1	1	1	1	1	6
NONE	OG0008459	1	1	1	1	1	1	6
NONE	OG0008460	1	1	1	1	1	1	6
NONE	OG0008461	1	1	1	1	1	1	6
NONE	OG0008462	1	1	1	1	1	1	6
NONE	OG0008463	1	1	1	1	1	1	6
NONE	OG0008464	1	1	1	1	1	1	6
NONE	OG0008465	1	1	1	1	1	1	6
NONE	OG0008466	1	1	1	1	1	1	6
NONE	OG0008467	1	1	1	1	1	1	6
NONE	OG0008468	1	1	1	1	1	1	6
NONE	OG0008469	1	1	1	1	1	1	6
NONE	OG0008470	1	1	1	1	1	1	6
NONE	OG0008471	1	0	2	1	1	1	6
NONE	OG0008472	1	1	1	1	1	1	6
NONE	OG0008473	1	1	1	1	1	1	6
NONE	OG0008474	1	1	1	1	1	1	6
NONE	OG0008475	1	1	1	1	1	1	6
NONE	OG0008476	1	1	1	1	1	1	6
NONE	OG0008477	1	1	1	1	1	1	6
NONE	OG0008478	1	1	1	1	1	1	6
NONE	OG0008479	1	1	1	1	1	1	6
NONE	OG0008480	1	1	1	1	1	1	6
NONE	OG0008481	1	1	1	1	1	1	6
NONE	OG0008482	1	1	1	1	1	1	6
NONE	OG0008483	1	1	1	1	1	1	6
NONE	OG0008484	1	1	1	1	1	1	6
NONE	OG0008485	1	1	1	1	1	1	6
NONE	OG0008486	1	1	1	0	2	1	6
NONE	OG0008487	1	1	1	1	1	1	6
NONE	OG0008488	1	1	1	1	1	1	6
NONE	OG0008489	1	1	1	1	1	1	6
NONE	OG0008490	1	1	1	1	1	1	6
NONE	OG0008491	1	1	1	1	1	1	6
NONE	OG0008492	1	1	1	1	1	1	6
NONE	OG0008493	1	1	1	1	1	1	6
NONE	OG0008494	1	1	1	1	1	1	6
NONE	OG0008495	1	1	1	1	1	1	6
NONE	OG0008496	1	0	2	1	1	1	6
NONE	OG0008497	1	1	1	1	1	1	6
NONE	OG0008498	1	1	1	1	1	1	6
NONE	OG0008499	1	1	1	1	1	1	6
NONE	OG0008500	1	1	1	1	1	1	6
NONE	OG0008501	1	0	4	0	0	1	6
NONE	OG0008502	1	1	1	1	1	1	6
NONE	OG0008503	1	1	1	1	1	1	6
NONE	OG0008504	1	1	1	1	1	1	6
NONE	OG0008505	1	1	1	1	1	1	6
NONE	OG0008506	1	1	1	1	1	1	6
NONE	OG0008507	1	1	1	1	1	1	6
NONE	OG0008508	1	1	1	1	1	1	6
NONE	OG0008509	1	1	1	1	1	1	6
NONE	OG0008510	1	1	1	1	1	1	6
NONE	OG0008511	1	1	1	1	1	1	6
NONE	OG0008512	0	1	2	1	1	1	6
NONE	OG0008513	0	1	1	2	1	1	6
NONE	OG0008514	0	1	1	1	1	2	6
NONE	OG0008515	0	1	1	2	1	1	6
NONE	OG0008516	0	1	2	1	1	1	6
NONE	OG0008517	0	1	1	1	2	1	6
NONE	OG0008518	0	1	1	2	1	1	6
NONE	OG0008519	0	2	1	1	0	2	6
NONE	OG0008520	0	2	1	1	1	1	6
NONE	OG0008521	0	1	1	2	1	1	6
NONE	OG0008522	0	1	2	1	1	1	6
NONE	OG0008523	0	1	1	2	1	1	6
NONE	OG0008524	0	1	2	1	1	1	6
NONE	OG0008525	0	6	0	0	0	0	6
NONE	OG0008526	0	1	1	1	2	1	6
NONE	OG0008527	0	1	1	2	1	1	6
NONE	OG0008528	0	1	1	2	1	1	6
NONE	OG0008529	0	1	2	1	1	1	6
NONE	OG0008530	0	1	2	1	1	1	6
NONE	OG0008531	0	1	2	1	1	1	6
NONE	OG0008532	0	1	1	1	2	1	6
NONE	OG0008533	0	1	1	2	1	1	6
NONE	OG0008534	0	2	0	4	0	0	6
NONE	OG0008535	0	1	1	2	1	1	6
NONE	OG0008536	0	1	1	1	2	1	6
NONE	OG0008537	0	2	1	1	1	1	6
NONE	OG0008538	0	1	1	2	1	1	6
NONE	OG0008539	0	1	1	2	1	1	6
NONE	OG0008540	0	0	3	3	0	0	6
NONE	OG0008541	0	0	6	0	0	0	6
NONE	OG0008542	0	0	6	0	0	0	6
NONE	OG0008543	0	0	3	1	0	2	6
NONE	OG0008544	0	0	5	0	0	1	6
NONE	OG0008545	0	0	5	0	0	1	6
NONE	OG0008546	0	0	2	0	0	4	6
NONE	OG0008547	0	0	2	2	0	2	6
NONE	OG0008548	0	0	1	0	0	5	6
NONE	OG0008549	0	0	6	0	0	0	6
NONE	OG0008550	0	0	6	0	0	0	6
NONE	OG0008551	0	0	5	0	0	1	6
NONE	OG0008552	0	0	6	0	0	0	6
NONE	OG0008553	0	0	6	0	0	0	6
NONE	OG0008554	0	0	1	1	3	1	6
NONE	OG0008555	0	0	6	0	0	0	6
NONE	OG0008556	0	0	2	1	2	1	6
NONE	OG0008557	0	0	3	3	0	0	6
NONE	OG0008558	0	0	6	0	0	0	6
NONE	OG0008559	0	0	1	0	0	5	6
NONE	OG0008560	0	0	1	0	0	5	6
NONE	OG0008561	0	0	6	0	0	0	6
NONE	OG0008562	0	0	1	1	1	3	6
NONE	OG0008563	0	0	2	1	0	3	6
NONE	OG0008564	0	0	1	0	2	3	6
NONE	OG0008565	0	0	6	0	0	0	6
NONE	OG0008566	0	0	6	0	0	0	6
NONE	OG0008567	0	0	2	0	0	4	6
NONE	OG0008568	0	0	0	6	0	0	6
NONE	OG0008569	0	0	0	6	0	0	6
NONE	OG0008570	0	0	0	6	0	0	6
NONE	OG0008571	0	0	0	6	0	0	6
NONE	OG0008572	0	0	0	6	0	0	6
NONE	OG0008573	0	0	0	3	0	3	6
NONE	OG0008574	0	0	0	6	0	0	6
NONE	OG0008575	0	0	0	6	0	0	6
NONE	OG0008576	0	0	0	2	0	4	6
NONE	OG0008577	0	0	0	6	0	0	6
NONE	OG0008578	0	0	0	5	0	1	6
NONE	OG0008579	0	0	0	6	0	0	6
NONE	OG0008580	0	0	0	5	1	0	6
NONE	OG0008581	0	0	0	6	0	0	6
NONE	OG0008582	0	0	0	4	0	2	6
NONE	OG0008583	0	0	0	1	0	5	6
NONE	OG0008584	0	0	0	0	6	0	6
NONE	OG0008585	0	0	0	0	6	0	6
NONE	OG0008586	0	0	0	0	6	0	6
NONE	OG0008587	0	0	0	0	6	0	6
NONE	OG0008588	0	0	0	0	6	0	6
NONE	OG0008589	0	0	0	0	6	0	6
NONE	OG0008590	0	0	0	0	6	0	6
NONE	OG0008591	0	0	0	0	6	0	6
NONE	OG0008592	0	0	0	0	6	0	6
NONE	OG0008593	0	0	0	0	6	0	6
NONE	OG0008594	0	0	0	0	6	0	6
NONE	OG0008595	0	0	0	0	6	0	6
NONE	OG0008596	0	0	0	0	6	0	6
NONE	OG0008597	0	0	0	0	6	0	6
NONE	OG0008598	0	0	0	0	6	0	6
NONE	OG0008599	0	0	0	0	6	0	6
NONE	OG0008600	0	0	0	0	6	0	6
NONE	OG0008601	0	0	0	0	6	0	6
NONE	OG0008602	0	0	0	0	0	6	6
NONE	OG0008603	0	0	0	0	0	6	6
NONE	OG0008604	0	0	0	0	0	6	6
NONE	OG0008605	0	0	0	0	0	6	6
NONE	OG0008606	0	0	0	0	0	6	6
NONE	OG0008607	0	0	0	0	0	6	6
NONE	OG0008608	0	0	0	0	0	6	6
NONE	OG0008609	0	0	0	0	0	6	6
NONE	OG0008610	0	0	0	0	0	6	6
NONE	OG0008611	0	0	0	0	0	6	6
NONE	OG0008612	0	0	0	0	0	6	6
NONE	OG0008613	0	0	0	0	0	6	6
NONE	OG0008614	0	0	0	0	0	6	6
NONE	OG0008615	0	0	0	0	0	6	6
NONE	OG0008616	1	1	1	1	0	1	5
NONE	OG0008617	1	0	1	1	1	1	5
NONE	OG0008618	1	1	1	0	1	1	5
NONE	OG0008619	1	1	1	0	1	1	5
NONE	OG0008620	1	0	1	1	1	1	5
NONE	OG0008621	1	0	2	0	0	2	5
NONE	OG0008622	1	0	1	1	1	1	5
NONE	OG0008623	2	0	0	1	1	1	5
NONE	OG0008624	1	0	1	1	1	1	5
NONE	OG0008625	1	1	1	1	0	1	5
NONE	OG0008626	1	1	1	1	0	1	5
NONE	OG0008627	1	1	0	1	1	1	5
NONE	OG0008628	1	1	0	1	1	1	5
NONE	OG0008629	2	0	1	0	1	1	5
NONE	OG0008630	1	1	0	1	1	1	5
NONE	OG0008631	1	0	1	1	1	1	5
NONE	OG0008632	1	0	1	1	1	1	5
NONE	OG0008633	1	0	1	1	1	1	5
NONE	OG0008634	1	0	4	0	0	0	5
NONE	OG0008635	1	1	1	1	0	1	5
NONE	OG0008636	1	0	1	1	1	1	5
NONE	OG0008637	1	1	1	1	0	1	5
NONE	OG0008638	1	0	1	1	1	1	5
NONE	OG0008639	3	0	2	0	0	0	5
NONE	OG0008640	1	0	1	1	1	1	5
NONE	OG0008641	1	1	1	1	0	1	5
NONE	OG0008642	1	1	0	1	1	1	5
NONE	OG0008643	3	0	2	0	0	0	5
NONE	OG0008644	1	0	1	1	1	1	5
NONE	OG0008645	5	0	0	0	0	0	5
NONE	OG0008646	1	0	1	1	1	1	5
NONE	OG0008647	1	1	1	1	0	1	5
NONE	OG0008648	5	0	0	0	0	0	5
NONE	OG0008649	1	1	1	0	1	1	5
NONE	OG0008650	1	0	3	0	0	1	5
NONE	OG0008651	1	1	1	0	1	1	5
NONE	OG0008652	1	1	1	0	1	1	5
NONE	OG0008653	1	1	1	0	1	1	5
NONE	OG0008654	1	1	1	0	1	1	5
NONE	OG0008655	1	1	1	0	1	1	5
NONE	OG0008656	1	1	1	0	1	1	5
NONE	OG0008657	1	1	1	0	1	1	5
NONE	OG0008658	1	0	1	1	1	1	5
NONE	OG0008659	1	1	1	1	0	1	5
NONE	OG0008660	3	0	1	1	0	0	5
NONE	OG0008661	1	1	1	1	0	1	5
NONE	OG0008662	1	0	1	1	1	1	5
NONE	OG0008663	1	1	1	1	0	1	5
NONE	OG0008664	1	0	1	1	1	1	5
NONE	OG0008665	2	0	2	0	0	1	5
NONE	OG0008666	1	0	1	1	1	1	5
NONE	OG0008667	1	0	1	1	1	1	5
NONE	OG0008668	1	0	1	1	1	1	5
NONE	OG0008669	1	0	1	1	1	1	5
NONE	OG0008670	1	0	1	1	1	1	5
NONE	OG0008671	3	0	0	0	0	2	5
NONE	OG0008672	1	0	1	1	1	1	5
NONE	OG0008673	1	0	1	1	1	1	5
NONE	OG0008674	5	0	0	0	0	0	5
NONE	OG0008675	1	1	0	1	1	1	5
NONE	OG0008676	1	1	1	1	0	1	5
NONE	OG0008677	1	0	1	1	1	1	5
NONE	OG0008678	1	0	2	1	0	1	5
NONE	OG0008679	1	1	1	1	0	1	5
NONE	OG0008680	1	0	1	1	1	1	5
NONE	OG0008681	1	1	1	1	0	1	5
NONE	OG0008682	1	0	1	1	1	1	5
NONE	OG0008683	1	1	1	1	0	1	5
NONE	OG0008684	2	0	1	0	0	2	5
NONE	OG0008685	1	0	1	1	1	1	5
NONE	OG0008686	1	0	1	1	1	1	5
NONE	OG0008687	1	0	1	1	1	1	5
NONE	OG0008688	1	0	1	1	1	1	5
NONE	OG0008689	1	0	1	1	1	1	5
NONE	OG0008690	1	0	1	1	1	1	5
NONE	OG0008691	1	1	1	1	0	1	5
NONE	OG0008692	1	1	1	1	0	1	5
NONE	OG0008693	1	1	1	1	0	1	5
NONE	OG0008694	1	1	1	1	0	1	5
NONE	OG0008695	1	0	1	1	1	1	5
NONE	OG0008696	1	0	1	1	1	1	5
NONE	OG0008697	1	1	1	1	0	1	5
NONE	OG0008698	1	0	1	1	1	1	5
NONE	OG0008699	1	0	1	1	1	1	5
NONE	OG0008700	1	0	1	1	1	1	5
NONE	OG0008701	1	0	1	1	1	1	5
NONE	OG0008702	1	0	1	1	1	1	5
NONE	OG0008703	5	0	0	0	0	0	5
NONE	OG0008704	1	0	1	1	1	1	5
NONE	OG0008705	4	0	1	0	0	0	5
NONE	OG0008706	1	0	2	1	0	1	5
NONE	OG0008707	1	0	1	1	1	1	5
NONE	OG0008708	1	0	1	1	1	1	5
NONE	OG0008709	2	0	1	1	0	1	5
NONE	OG0008710	1	0	1	1	1	1	5
NONE	OG0008711	1	1	1	1	0	1	5
NONE	OG0008712	1	0	1	1	1	1	5
NONE	OG0008713	1	1	1	0	1	1	5
NONE	OG0008714	1	1	1	1	0	1	5
NONE	OG0008715	1	1	1	1	1	0	5
NONE	OG0008716	1	1	1	0	1	1	5
NONE	OG0008717	1	1	1	1	0	1	5
NONE	OG0008718	1	0	1	1	1	1	5
NONE	OG0008719	1	0	1	1	1	1	5
NONE	OG0008720	1	0	1	1	1	1	5
NONE	OG0008721	1	0	1	1	1	1	5
NONE	OG0008722	1	0	1	1	1	1	5
NONE	OG0008723	1	0	1	1	1	1	5
NONE	OG0008724	1	1	1	1	0	1	5
NONE	OG0008725	1	0	1	1	1	1	5
NONE	OG0008726	1	0	2	1	0	1	5
NONE	OG0008727	1	0	2	1	0	1	5
NONE	OG0008728	1	0	1	1	1	1	5
NONE	OG0008729	1	0	1	3	0	0	5
NONE	OG0008730	1	0	1	1	1	1	5
NONE	OG0008731	1	0	1	1	1	1	5
NONE	OG0008732	1	1	1	1	0	1	5
NONE	OG0008733	1	0	1	1	1	1	5
NONE	OG0008734	1	0	1	1	1	1	5
NONE	OG0008735	1	0	1	1	1	1	5
NONE	OG0008736	1	1	1	1	0	1	5
NONE	OG0008737	2	0	1	2	0	0	5
NONE	OG0008738	1	0	1	1	1	1	5
NONE	OG0008739	1	0	1	1	1	1	5
NONE	OG0008740	1	0	1	1	1	1	5
NONE	OG0008741	1	0	1	1	1	1	5
NONE	OG0008742	1	0	1	1	1	1	5
NONE	OG0008743	4	0	1	0	0	0	5
NONE	OG0008744	1	1	1	1	0	1	5
NONE	OG0008745	4	0	0	0	0	1	5
NONE	OG0008746	1	2	1	1	0	0	5
NONE	OG0008747	1	0	1	1	1	1	5
NONE	OG0008748	1	1	2	0	0	1	5
NONE	OG0008749	4	0	0	0	0	1	5
NONE	OG0008750	1	1	1	1	0	1	5
NONE	OG0008751	1	1	1	0	0	2	5
NONE	OG0008752	1	0	1	1	1	1	5
NONE	OG0008753	1	1	1	1	0	1	5
NONE	OG0008754	1	1	1	1	0	1	5
NONE	OG0008755	2	1	1	0	0	1	5
NONE	OG0008756	1	0	1	1	1	1	5
NONE	OG0008757	1	0	1	1	1	1	5
NONE	OG0008758	1	0	1	1	1	1	5
NONE	OG0008759	1	0	1	1	1	1	5
NONE	OG0008760	1	0	1	1	1	1	5
NONE	OG0008761	1	0	1	1	1	1	5
NONE	OG0008762	1	1	1	1	0	1	5
NONE	OG0008763	1	1	1	1	0	1	5
NONE	OG0008764	1	0	2	1	0	1	5
NONE	OG0008765	1	1	1	1	0	1	5
NONE	OG0008766	1	0	1	1	1	1	5
NONE	OG0008767	4	0	0	0	0	1	5
NONE	OG0008768	5	0	0	0	0	0	5
NONE	OG0008769	1	1	1	0	1	1	5
NONE	OG0008770	1	1	1	0	1	1	5
NONE	OG0008771	1	0	1	1	1	1	5
NONE	OG0008772	1	0	1	1	1	1	5
NONE	OG0008773	1	1	1	0	1	1	5
NONE	OG0008774	1	0	1	1	1	1	5
NONE	OG0008775	1	1	1	1	0	1	5
NONE	OG0008776	3	0	2	0	0	0	5
NONE	OG0008777	1	1	1	1	0	1	5
NONE	OG0008778	1	1	1	1	0	1	5
NONE	OG0008779	1	1	1	1	0	1	5
NONE	OG0008780	1	0	1	1	1	1	5
NONE	OG0008781	1	1	1	1	0	1	5
NONE	OG0008782	1	0	1	1	1	1	5
NONE	OG0008783	1	1	1	1	0	1	5
NONE	OG0008784	1	1	1	1	0	1	5
NONE	OG0008785	1	0	1	1	1	1	5
NONE	OG0008786	1	0	1	2	0	1	5
NONE	OG0008787	1	1	1	0	1	1	5
NONE	OG0008788	1	0	1	1	1	1	5
NONE	OG0008789	1	0	1	1	1	1	5
NONE	OG0008790	1	1	1	1	0	1	5
NONE	OG0008791	1	0	1	1	1	1	5
NONE	OG0008792	1	1	1	0	1	1	5
NONE	OG0008793	1	0	1	1	1	1	5
NONE	OG0008794	1	1	1	1	0	1	5
NONE	OG0008795	1	1	1	1	0	1	5
NONE	OG0008796	1	0	1	1	1	1	5
NONE	OG0008797	1	1	1	1	0	1	5
NONE	OG0008798	1	0	1	1	1	1	5
NONE	OG0008799	1	0	1	1	1	1	5
NONE	OG0008800	1	1	1	1	0	1	5
NONE	OG0008801	1	1	1	1	0	1	5
NONE	OG0008802	1	1	1	1	0	1	5
NONE	OG0008803	1	0	1	1	1	1	5
NONE	OG0008804	1	0	1	1	1	1	5
NONE	OG0008805	1	0	1	1	1	1	5
NONE	OG0008806	1	0	1	1	1	1	5
NONE	OG0008807	1	1	1	1	0	1	5
NONE	OG0008808	1	0	1	1	1	1	5
NONE	OG0008809	1	1	1	1	0	1	5
NONE	OG0008810	5	0	0	0	0	0	5
NONE	OG0008811	1	0	1	1	1	1	5
NONE	OG0008812	1	0	1	1	1	1	5
NONE	OG0008813	2	0	3	0	0	0	5
NONE	OG0008814	1	0	1	1	0	2	5
NONE	OG0008815	1	0	1	1	1	1	5
NONE	OG0008816	1	0	1	1	1	1	5
NONE	OG0008817	1	1	1	1	0	1	5
NONE	OG0008818	1	0	1	1	1	1	5
NONE	OG0008819	1	1	1	1	0	1	5
NONE	OG0008820	4	0	1	0	0	0	5
NONE	OG0008821	1	1	1	1	0	1	5
NONE	OG0008822	1	1	1	1	0	1	5
NONE	OG0008823	1	0	1	1	1	1	5
NONE	OG0008824	1	0	1	1	1	1	5
NONE	OG0008825	1	1	1	1	0	1	5
NONE	OG0008826	1	1	1	1	0	1	5
NONE	OG0008827	1	1	1	1	0	1	5
NONE	OG0008828	1	0	1	1	1	1	5
NONE	OG0008829	1	0	1	1	1	1	5
NONE	OG0008830	1	1	1	0	1	1	5
NONE	OG0008831	1	1	1	0	1	1	5
NONE	OG0008832	1	1	1	0	1	1	5
NONE	OG0008833	2	0	3	0	0	0	5
NONE	OG0008834	5	0	0	0	0	0	5
NONE	OG0008835	1	0	1	1	1	1	5
NONE	OG0008836	1	0	1	1	1	1	5
NONE	OG0008837	2	0	3	0	0	0	5
NONE	OG0008838	2	0	3	0	0	0	5
NONE	OG0008839	1	0	1	1	1	1	5
NONE	OG0008840	1	0	1	1	1	1	5
NONE	OG0008841	1	0	1	1	1	1	5
NONE	OG0008842	2	0	1	1	0	1	5
NONE	OG0008843	2	0	1	2	0	0	5
NONE	OG0008844	5	0	0	0	0	0	5
NONE	OG0008845	3	0	1	0	0	1	5
NONE	OG0008846	1	1	1	1	0	1	5
NONE	OG0008847	1	0	1	1	1	1	5
NONE	OG0008848	1	0	1	1	1	1	5
NONE	OG0008849	1	0	1	1	1	1	5
NONE	OG0008850	1	0	1	1	1	1	5
NONE	OG0008851	1	0	1	1	1	1	5
NONE	OG0008852	2	1	1	0	0	1	5
NONE	OG0008853	1	1	1	1	0	1	5
NONE	OG0008854	1	1	1	1	0	1	5
NONE	OG0008855	1	1	1	1	0	1	5
NONE	OG0008856	1	1	1	1	0	1	5
NONE	OG0008857	1	0	1	1	1	1	5
NONE	OG0008858	1	1	1	1	0	1	5
NONE	OG0008859	1	1	1	1	0	1	5
NONE	OG0008860	1	0	1	1	1	1	5
NONE	OG0008861	1	0	1	2	0	1	5
NONE	OG0008862	1	0	1	1	1	1	5
NONE	OG0008863	4	0	1	0	0	0	5
NONE	OG0008864	1	1	1	1	0	1	5
NONE	OG0008865	1	1	1	1	0	1	5
NONE	OG0008866	5	0	0	0	0	0	5
NONE	OG0008867	1	0	1	1	1	1	5
NONE	OG0008868	1	0	1	1	1	1	5
NONE	OG0008869	5	0	0	0	0	0	5
NONE	OG0008870	1	0	1	1	1	1	5
NONE	OG0008871	4	0	0	0	0	1	5
NONE	OG0008872	1	1	1	1	0	1	5
NONE	OG0008873	1	1	1	1	0	1	5
NONE	OG0008874	2	0	1	2	0	0	5
NONE	OG0008875	1	0	1	1	1	1	5
NONE	OG0008876	5	0	0	0	0	0	5
NONE	OG0008877	2	0	1	2	0	0	5
NONE	OG0008878	4	0	1	0	0	0	5
NONE	OG0008879	1	0	1	1	0	2	5
NONE	OG0008880	1	1	1	1	0	1	5
NONE	OG0008881	1	1	1	1	0	1	5
NONE	OG0008882	1	0	1	1	1	1	5
NONE	OG0008883	2	0	1	1	0	1	5
NONE	OG0008884	2	0	1	1	0	1	5
NONE	OG0008885	1	1	1	1	0	1	5
NONE	OG0008886	5	0	0	0	0	0	5
NONE	OG0008887	1	0	1	1	1	1	5
NONE	OG0008888	1	1	1	1	1	0	5
NONE	OG0008889	1	0	1	1	1	1	5
NONE	OG0008890	4	0	1	0	0	0	5
NONE	OG0008891	1	0	1	1	1	1	5
NONE	OG0008892	1	1	1	1	0	1	5
NONE	OG0008893	1	1	1	1	0	1	5
NONE	OG0008894	2	0	1	1	0	1	5
NONE	OG0008895	1	1	1	1	0	1	5
NONE	OG0008896	1	0	1	1	1	1	5
NONE	OG0008897	1	0	1	2	0	1	5
NONE	OG0008898	1	1	1	1	0	1	5
NONE	OG0008899	2	0	1	0	1	1	5
NONE	OG0008900	1	1	1	1	0	1	5
NONE	OG0008901	1	1	2	1	0	0	5
NONE	OG0008902	1	0	2	1	0	1	5
NONE	OG0008903	1	0	1	1	1	1	5
NONE	OG0008904	1	1	1	1	0	1	5
NONE	OG0008905	1	1	1	1	0	1	5
NONE	OG0008906	1	1	1	1	0	1	5
NONE	OG0008907	1	1	1	1	0	1	5
NONE	OG0008908	1	1	1	1	0	1	5
NONE	OG0008909	1	1	1	1	0	1	5
NONE	OG0008910	1	1	1	1	0	1	5
NONE	OG0008911	1	1	1	1	0	1	5
NONE	OG0008912	1	0	1	1	1	1	5
NONE	OG0008913	1	1	1	1	0	1	5
NONE	OG0008914	4	0	0	0	0	1	5
NONE	OG0008915	1	0	1	2	1	0	5
NONE	OG0008916	1	0	1	1	1	1	5
NONE	OG0008917	1	0	1	1	1	1	5
NONE	OG0008918	1	0	1	1	1	1	5
NONE	OG0008919	1	0	1	1	1	1	5
NONE	OG0008920	1	0	1	1	1	1	5
NONE	OG0008921	1	0	1	1	1	1	5
NONE	OG0008922	2	0	1	0	1	1	5
NONE	OG0008923	1	0	1	2	0	1	5
NONE	OG0008924	1	1	1	1	0	1	5
NONE	OG0008925	1	1	1	1	0	1	5
NONE	OG0008926	1	0	1	1	1	1	5
NONE	OG0008927	1	1	1	1	0	1	5
NONE	OG0008928	1	0	1	1	1	1	5
NONE	OG0008929	1	1	1	1	0	1	5
NONE	OG0008930	1	1	1	1	0	1	5
NONE	OG0008931	1	1	1	1	0	1	5
NONE	OG0008932	1	1	1	1	0	1	5
NONE	OG0008933	1	0	1	1	1	1	5
NONE	OG0008934	1	1	1	1	0	1	5
NONE	OG0008935	1	1	1	1	0	1	5
NONE	OG0008936	1	1	1	1	0	1	5
NONE	OG0008937	1	0	1	1	1	1	5
NONE	OG0008938	1	1	1	1	0	1	5
NONE	OG0008939	1	0	1	1	1	1	5
NONE	OG0008940	1	0	1	1	1	1	5
NONE	OG0008941	1	1	1	1	0	1	5
NONE	OG0008942	1	0	1	1	1	1	5
NONE	OG0008943	1	0	1	1	1	1	5
NONE	OG0008944	2	0	1	1	0	1	5
NONE	OG0008945	1	0	1	2	0	1	5
NONE	OG0008946	1	1	1	1	0	1	5
NONE	OG0008947	1	1	1	1	0	1	5
NONE	OG0008948	1	0	1	1	1	1	5
NONE	OG0008949	3	0	2	0	0	0	5
NONE	OG0008950	1	1	1	1	0	1	5
NONE	OG0008951	1	1	1	1	0	1	5
NONE	OG0008952	1	0	1	1	1	1	5
NONE	OG0008953	3	0	1	1	0	0	5
NONE	OG0008954	1	1	1	1	0	1	5
NONE	OG0008955	4	0	0	0	1	0	5
NONE	OG0008956	1	0	1	1	1	1	5
NONE	OG0008957	1	1	1	1	0	1	5
NONE	OG0008958	1	1	1	1	1	0	5
NONE	OG0008959	1	1	1	1	0	1	5
NONE	OG0008960	1	1	1	1	0	1	5
NONE	OG0008961	1	0	1	1	1	1	5
NONE	OG0008962	1	0	1	1	1	1	5
NONE	OG0008963	1	1	1	0	1	1	5
NONE	OG0008964	1	1	1	0	1	1	5
NONE	OG0008965	1	1	1	0	1	1	5
NONE	OG0008966	2	1	1	0	1	0	5
NONE	OG0008967	1	1	1	0	1	1	5
NONE	OG0008968	1	1	1	0	1	1	5
NONE	OG0008969	1	1	1	1	1	0	5
NONE	OG0008970	1	0	1	1	1	1	5
NONE	OG0008971	1	1	1	0	1	1	5
NONE	OG0008972	1	1	1	0	1	1	5
NONE	OG0008973	1	1	1	0	1	1	5
NONE	OG0008974	1	1	1	0	1	1	5
NONE	OG0008975	1	1	1	0	1	1	5
NONE	OG0008976	1	1	1	0	1	1	5
NONE	OG0008977	1	1	1	0	1	1	5
NONE	OG0008978	2	1	1	0	1	0	5
NONE	OG0008979	1	1	1	0	1	1	5
NONE	OG0008980	1	1	1	0	1	1	5
NONE	OG0008981	1	1	1	0	1	1	5
NONE	OG0008982	1	1	1	0	1	1	5
NONE	OG0008983	1	1	1	0	1	1	5
NONE	OG0008984	1	0	1	1	1	1	5
NONE	OG0008985	1	1	1	0	1	1	5
NONE	OG0008986	1	0	1	1	1	1	5
NONE	OG0008987	1	0	1	0	2	1	5
NONE	OG0008988	1	1	1	0	1	1	5
NONE	OG0008989	1	1	1	0	1	1	5
NONE	OG0008990	1	1	1	0	1	1	5
NONE	OG0008991	1	1	1	0	1	1	5
NONE	OG0008992	1	1	1	0	1	1	5
NONE	OG0008993	1	1	1	0	1	1	5
NONE	OG0008994	1	1	1	1	0	1	5
NONE	OG0008995	1	1	1	0	1	1	5
NONE	OG0008996	1	0	1	1	1	1	5
NONE	OG0008997	1	1	1	0	1	1	5
NONE	OG0008998	2	0	2	0	0	1	5
NONE	OG0008999	3	0	2	0	0	0	5
NONE	OG0009000	1	1	1	0	1	1	5
NONE	OG0009001	2	0	2	1	0	0	5
NONE	OG0009002	1	0	1	1	1	1	5
NONE	OG0009003	1	0	0	1	3	0	5
NONE	OG0009004	1	0	1	1	1	1	5
NONE	OG0009005	1	1	1	0	1	1	5
NONE	OG0009006	1	1	1	0	1	1	5
NONE	OG0009007	1	1	1	0	1	1	5
NONE	OG0009008	1	1	1	0	1	1	5
NONE	OG0009009	1	1	1	0	1	1	5
NONE	OG0009010	1	1	1	0	1	1	5
NONE	OG0009011	1	1	1	0	1	1	5
NONE	OG0009012	1	1	1	1	1	0	5
NONE	OG0009013	1	1	1	1	1	0	5
NONE	OG0009014	1	0	1	1	1	1	5
NONE	OG0009015	1	0	1	1	1	1	5
NONE	OG0009016	1	0	1	1	1	1	5
NONE	OG0009017	1	0	1	1	1	1	5
NONE	OG0009018	1	0	1	1	1	1	5
NONE	OG0009019	1	1	1	1	0	1	5
NONE	OG0009020	1	1	1	1	0	1	5
NONE	OG0009021	1	1	1	1	0	1	5
NONE	OG0009022	1	0	1	1	1	1	5
NONE	OG0009023	1	1	1	1	0	1	5
NONE	OG0009024	1	0	1	1	1	1	5
NONE	OG0009025	1	1	1	1	0	1	5
NONE	OG0009026	1	1	1	1	0	1	5
NONE	OG0009027	1	1	1	0	1	1	5
NONE	OG0009028	1	1	1	1	0	1	5
NONE	OG0009029	1	1	1	2	0	0	5
NONE	OG0009030	1	1	1	0	1	1	5
NONE	OG0009031	1	0	1	1	1	1	5
NONE	OG0009032	1	0	1	1	1	1	5
NONE	OG0009033	5	0	0	0	0	0	5
NONE	OG0009034	3	0	1	1	0	0	5
NONE	OG0009035	1	1	1	1	0	1	5
NONE	OG0009036	1	0	1	1	1	1	5
NONE	OG0009037	1	1	1	1	0	1	5
NONE	OG0009038	1	1	1	1	0	1	5
NONE	OG0009039	1	1	1	1	0	1	5
NONE	OG0009040	1	0	1	1	1	1	5
NONE	OG0009041	1	1	1	1	0	1	5
NONE	OG0009042	1	0	1	1	1	1	5
NONE	OG0009043	1	0	1	1	1	1	5
NONE	OG0009044	1	1	1	1	0	1	5
NONE	OG0009045	1	0	1	1	1	1	5
NONE	OG0009046	1	1	1	1	0	1	5
NONE	OG0009047	1	1	1	1	0	1	5
NONE	OG0009048	1	0	1	1	1	1	5
NONE	OG0009049	1	1	1	1	0	1	5
NONE	OG0009050	1	0	1	1	1	1	5
NONE	OG0009051	1	1	1	1	0	1	5
NONE	OG0009052	1	1	1	1	0	1	5
NONE	OG0009053	2	0	3	0	0	0	5
NONE	OG0009054	3	0	2	0	0	0	5
NONE	OG0009055	1	0	4	0	0	0	5
NONE	OG0009056	1	0	3	0	0	1	5
NONE	OG0009057	4	0	1	0	0	0	5
NONE	OG0009058	1	1	1	1	0	1	5
NONE	OG0009059	1	0	1	1	1	1	5
NONE	OG0009060	1	1	1	1	0	1	5
NONE	OG0009061	1	0	1	1	1	1	5
NONE	OG0009062	1	0	1	1	1	1	5
NONE	OG0009063	1	0	1	1	1	1	5
NONE	OG0009064	1	1	1	1	0	1	5
NONE	OG0009065	1	1	1	1	1	0	5
NONE	OG0009066	1	1	1	1	0	1	5
NONE	OG0009067	1	1	1	1	0	1	5
NONE	OG0009068	1	0	1	1	1	1	5
NONE	OG0009069	1	0	1	1	1	1	5
NONE	OG0009070	4	0	0	1	0	0	5
NONE	OG0009071	1	1	1	1	0	1	5
NONE	OG0009072	1	0	1	1	1	1	5
NONE	OG0009073	1	0	1	1	1	1	5
NONE	OG0009074	2	0	0	3	0	0	5
NONE	OG0009075	1	1	1	1	1	0	5
NONE	OG0009076	1	1	1	1	0	1	5
NONE	OG0009077	1	1	1	1	0	1	5
NONE	OG0009078	1	1	1	1	1	0	5
NONE	OG0009079	2	0	1	1	1	0	5
NONE	OG0009080	1	0	1	2	0	1	5
NONE	OG0009081	1	1	1	1	0	1	5
NONE	OG0009082	1	1	1	1	0	1	5
NONE	OG0009083	2	0	1	1	0	1	5
NONE	OG0009084	1	1	1	0	1	1	5
NONE	OG0009085	1	0	1	1	1	1	5
NONE	OG0009086	1	1	0	1	1	1	5
NONE	OG0009087	1	1	1	1	0	1	5
NONE	OG0009088	1	0	1	1	1	1	5
NONE	OG0009089	1	0	4	0	0	0	5
NONE	OG0009090	1	0	1	2	0	1	5
NONE	OG0009091	1	1	1	2	0	0	5
NONE	OG0009092	1	0	1	1	1	1	5
NONE	OG0009093	1	0	1	1	1	1	5
NONE	OG0009094	1	0	4	0	0	0	5
NONE	OG0009095	1	1	1	0	1	1	5
NONE	OG0009096	1	1	1	0	1	1	5
NONE	OG0009097	1	1	1	0	1	1	5
NONE	OG0009098	1	1	1	1	0	1	5
NONE	OG0009099	2	0	2	0	0	1	5
NONE	OG0009100	1	0	1	1	1	1	5
NONE	OG0009101	1	1	1	1	0	1	5
NONE	OG0009102	1	0	1	1	1	1	5
NONE	OG0009103	4	0	0	0	0	1	5
NONE	OG0009104	1	0	1	1	1	1	5
NONE	OG0009105	1	0	1	1	1	1	5
NONE	OG0009106	1	1	1	1	0	1	5
NONE	OG0009107	1	1	1	1	0	1	5
NONE	OG0009108	1	1	1	1	0	1	5
NONE	OG0009109	1	0	1	1	1	1	5
NONE	OG0009110	1	0	1	1	1	1	5
NONE	OG0009111	1	0	1	1	1	1	5
NONE	OG0009112	2	0	1	1	0	1	5
NONE	OG0009113	1	1	1	1	1	0	5
NONE	OG0009114	1	1	1	1	0	1	5
NONE	OG0009115	2	0	1	1	0	1	5
NONE	OG0009116	1	1	1	1	0	1	5
NONE	OG0009117	1	0	2	1	0	1	5
NONE	OG0009118	1	1	1	1	0	1	5
NONE	OG0009119	1	1	1	1	0	1	5
NONE	OG0009120	1	0	1	1	1	1	5
NONE	OG0009121	1	1	1	1	0	1	5
NONE	OG0009122	1	1	1	1	0	1	5
NONE	OG0009123	1	0	1	1	1	1	5
NONE	OG0009124	1	1	1	1	0	1	5
NONE	OG0009125	1	1	1	1	0	1	5
NONE	OG0009126	2	0	0	3	0	0	5
NONE	OG0009127	1	0	1	1	1	1	5
NONE	OG0009128	1	0	1	1	1	1	5
NONE	OG0009129	1	1	1	1	0	1	5
NONE	OG0009130	1	0	1	1	1	1	5
NONE	OG0009131	1	1	1	1	0	1	5
NONE	OG0009132	1	0	1	1	1	1	5
NONE	OG0009133	1	0	1	1	1	1	5
NONE	OG0009134	1	0	1	1	1	1	5
NONE	OG0009135	1	1	1	1	0	1	5
NONE	OG0009136	1	1	1	1	0	1	5
NONE	OG0009137	1	1	1	1	0	1	5
NONE	OG0009138	1	0	1	1	1	1	5
NONE	OG0009139	1	0	1	2	0	1	5
NONE	OG0009140	1	1	1	1	0	1	5
NONE	OG0009141	1	1	1	1	0	1	5
NONE	OG0009142	1	0	1	1	1	1	5
NONE	OG0009143	1	0	1	2	0	1	5
NONE	OG0009144	1	1	1	1	0	1	5
NONE	OG0009145	1	1	1	1	0	1	5
NONE	OG0009146	1	1	1	1	0	1	5
NONE	OG0009147	1	1	1	1	0	1	5
NONE	OG0009148	1	1	1	1	1	0	5
NONE	OG0009149	1	1	1	1	1	0	5
NONE	OG0009150	1	1	1	1	1	0	5
NONE	OG0009151	1	1	1	1	1	0	5
NONE	OG0009152	1	1	2	1	0	0	5
NONE	OG0009153	1	1	1	1	1	0	5
NONE	OG0009154	1	1	1	1	1	0	5
NONE	OG0009155	1	1	1	1	1	0	5
NONE	OG0009156	1	1	1	1	1	0	5
NONE	OG0009157	1	1	1	1	1	0	5
NONE	OG0009158	1	1	1	1	1	0	5
NONE	OG0009159	1	1	1	1	1	0	5
NONE	OG0009160	1	1	1	1	1	0	5
NONE	OG0009161	3	0	0	0	0	2	5
NONE	OG0009162	1	1	1	1	0	1	5
NONE	OG0009163	1	1	1	0	1	1	5
NONE	OG0009164	1	0	1	1	1	1	5
NONE	OG0009165	1	0	1	1	1	1	5
NONE	OG0009166	1	1	0	2	0	1	5
NONE	OG0009167	1	1	1	0	1	1	5
NONE	OG0009168	1	1	1	1	0	1	5
NONE	OG0009169	1	0	1	1	1	1	5
NONE	OG0009170	1	0	1	2	0	1	5
NONE	OG0009171	1	1	1	1	0	1	5
NONE	OG0009172	1	0	2	1	0	1	5
NONE	OG0009173	1	0	2	1	0	1	5
NONE	OG0009174	1	0	2	1	0	1	5
NONE	OG0009175	4	0	1	0	0	0	5
NONE	OG0009176	1	0	1	1	1	1	5
NONE	OG0009177	1	0	1	0	0	3	5
NONE	OG0009178	1	1	1	1	0	1	5
NONE	OG0009179	3	0	2	0	0	0	5
NONE	OG0009180	2	0	0	0	0	3	5
NONE	OG0009181	5	0	0	0	0	0	5
NONE	OG0009182	1	1	1	1	0	1	5
NONE	OG0009183	4	0	0	1	0	0	5
NONE	OG0009184	4	0	0	0	0	1	5
NONE	OG0009185	1	0	1	1	1	1	5
NONE	OG0009186	1	1	1	1	0	1	5
NONE	OG0009187	1	0	4	0	0	0	5
NONE	OG0009188	1	1	1	1	0	1	5
NONE	OG0009189	1	1	1	1	0	1	5
NONE	OG0009190	1	0	1	1	1	1	5
NONE	OG0009191	1	1	1	1	0	1	5
NONE	OG0009192	1	1	1	1	0	1	5
NONE	OG0009193	1	1	1	1	0	1	5
NONE	OG0009194	1	1	1	1	0	1	5
NONE	OG0009195	1	1	1	1	0	1	5
NONE	OG0009196	1	0	1	1	1	1	5
NONE	OG0009197	1	1	1	1	0	1	5
NONE	OG0009198	1	0	1	2	0	1	5
NONE	OG0009199	1	1	1	1	0	1	5
NONE	OG0009200	1	0	1	1	1	1	5
NONE	OG0009201	1	1	1	1	0	1	5
NONE	OG0009202	1	0	1	1	1	1	5
NONE	OG0009203	1	1	1	1	0	1	5
NONE	OG0009204	1	1	1	1	0	1	5
NONE	OG0009205	1	0	4	0	0	0	5
NONE	OG0009206	2	0	1	1	0	1	5
NONE	OG0009207	1	1	1	1	0	1	5
NONE	OG0009208	1	0	1	1	1	1	5
NONE	OG0009209	1	0	1	1	1	1	5
NONE	OG0009210	1	0	1	1	1	1	5
NONE	OG0009211	1	1	1	1	0	1	5
NONE	OG0009212	1	0	1	1	1	1	5
NONE	OG0009213	1	1	1	1	0	1	5
NONE	OG0009214	1	1	1	1	0	1	5
NONE	OG0009215	1	1	1	1	0	1	5
NONE	OG0009216	1	1	1	1	0	1	5
NONE	OG0009217	1	0	1	1	1	1	5
NONE	OG0009218	1	0	1	1	1	1	5
NONE	OG0009219	1	0	1	1	1	1	5
NONE	OG0009220	2	0	0	1	1	1	5
NONE	OG0009221	1	0	1	1	1	1	5
NONE	OG0009222	1	0	1	3	0	0	5
NONE	OG0009223	1	1	1	1	0	1	5
NONE	OG0009224	2	0	1	1	0	1	5
NONE	OG0009225	1	1	0	1	1	1	5
NONE	OG0009226	2	0	1	1	1	0	5
NONE	OG0009227	1	1	0	1	0	2	5
NONE	OG0009228	2	0	1	1	0	1	5
NONE	OG0009229	1	0	1	1	1	1	5
NONE	OG0009230	1	0	1	1	1	1	5
NONE	OG0009231	1	1	1	1	0	1	5
NONE	OG0009232	1	0	1	1	1	1	5
NONE	OG0009233	1	0	1	1	1	1	5
NONE	OG0009234	1	0	1	1	1	1	5
NONE	OG0009235	1	1	1	1	0	1	5
NONE	OG0009236	1	1	1	1	0	1	5
NONE	OG0009237	1	2	1	1	0	0	5
NONE	OG0009238	1	1	1	1	0	1	5
NONE	OG0009239	1	0	1	1	1	1	5
NONE	OG0009240	1	0	1	1	1	1	5
NONE	OG0009241	1	1	1	1	0	1	5
NONE	OG0009242	1	0	1	2	0	1	5
NONE	OG0009243	1	0	1	1	1	1	5
NONE	OG0009244	1	0	1	1	1	1	5
NONE	OG0009245	1	1	1	1	1	0	5
NONE	OG0009246	1	1	1	1	0	1	5
NONE	OG0009247	2	0	1	1	0	1	5
NONE	OG0009248	1	0	1	1	1	1	5
NONE	OG0009249	1	1	1	0	0	2	5
NONE	OG0009250	1	1	1	1	0	1	5
NONE	OG0009251	1	1	1	1	1	0	5
NONE	OG0009252	1	1	1	1	1	0	5
NONE	OG0009253	1	1	1	1	1	0	5
NONE	OG0009254	1	1	1	1	1	0	5
NONE	OG0009255	1	1	1	1	1	0	5
NONE	OG0009256	1	1	1	1	1	0	5
NONE	OG0009257	1	1	1	1	1	0	5
NONE	OG0009258	1	1	1	1	1	0	5
NONE	OG0009259	1	1	1	1	1	0	5
NONE	OG0009260	1	1	1	1	1	0	5
NONE	OG0009261	1	1	1	1	0	1	5
NONE	OG0009262	4	0	1	0	0	0	5
NONE	OG0009263	1	0	1	1	1	1	5
NONE	OG0009264	1	1	1	1	0	1	5
NONE	OG0009265	1	1	1	1	0	1	5
NONE	OG0009266	1	1	0	2	1	0	5
NONE	OG0009267	1	1	1	0	1	1	5
NONE	OG0009268	1	1	1	0	1	1	5
NONE	OG0009269	1	0	0	0	4	0	5
NONE	OG0009270	1	0	4	0	0	0	5
NONE	OG0009271	1	1	1	1	0	1	5
NONE	OG0009272	1	1	1	1	0	1	5
NONE	OG0009273	1	0	1	1	1	1	5
NONE	OG0009274	1	0	1	1	1	1	5
NONE	OG0009275	1	1	0	1	1	1	5
NONE	OG0009276	1	1	1	1	0	1	5
NONE	OG0009277	1	1	1	1	0	1	5
NONE	OG0009278	1	0	1	1	1	1	5
NONE	OG0009279	1	0	1	1	1	1	5
NONE	OG0009280	1	0	2	0	0	2	5
NONE	OG0009281	5	0	0	0	0	0	5
NONE	OG0009282	1	0	1	1	1	1	5
NONE	OG0009283	5	0	0	0	0	0	5
NONE	OG0009284	1	1	1	1	0	1	5
NONE	OG0009285	1	0	1	1	1	1	5
NONE	OG0009286	1	1	1	1	0	1	5
NONE	OG0009287	1	1	1	1	0	1	5
NONE	OG0009288	1	0	1	1	1	1	5
NONE	OG0009289	1	0	1	1	1	1	5
NONE	OG0009290	1	0	1	1	2	0	5
NONE	OG0009291	1	1	1	1	1	0	5
NONE	OG0009292	1	1	1	1	1	0	5
NONE	OG0009293	1	1	1	1	1	0	5
NONE	OG0009294	1	1	1	1	1	0	5
NONE	OG0009295	1	0	1	1	1	1	5
NONE	OG0009296	1	0	1	1	1	1	5
NONE	OG0009297	1	0	1	1	1	1	5
NONE	OG0009298	1	0	1	2	0	1	5
NONE	OG0009299	1	0	1	0	2	1	5
NONE	OG0009300	1	1	1	1	0	1	5
NONE	OG0009301	1	0	4	0	0	0	5
NONE	OG0009302	1	1	1	1	0	1	5
NONE	OG0009303	4	0	1	0	0	0	5
NONE	OG0009304	2	0	2	0	0	1	5
NONE	OG0009305	1	0	1	1	1	1	5
NONE	OG0009306	1	0	1	1	1	1	5
NONE	OG0009307	1	1	1	1	0	1	5
NONE	OG0009308	1	0	1	1	1	1	5
NONE	OG0009309	1	0	1	1	1	1	5
NONE	OG0009310	1	0	1	2	0	1	5
NONE	OG0009311	1	1	1	0	1	1	5
NONE	OG0009312	1	1	1	1	0	1	5
NONE	OG0009313	1	0	1	1	1	1	5
NONE	OG0009314	4	0	1	0	0	0	5
NONE	OG0009315	1	1	1	1	0	1	5
NONE	OG0009316	1	1	1	1	1	0	5
NONE	OG0009317	1	1	1	1	0	1	5
NONE	OG0009318	1	0	1	3	0	0	5
NONE	OG0009319	1	0	1	1	1	1	5
NONE	OG0009320	1	1	1	1	0	1	5
NONE	OG0009321	1	1	1	1	0	1	5
NONE	OG0009322	1	0	1	1	1	1	5
NONE	OG0009323	1	0	1	1	1	1	5
NONE	OG0009324	1	1	1	1	0	1	5
NONE	OG0009325	1	0	1	1	1	1	5
NONE	OG0009326	1	1	2	0	0	1	5
NONE	OG0009327	1	0	2	1	0	1	5
NONE	OG0009328	5	0	0	0	0	0	5
NONE	OG0009329	1	0	1	1	1	1	5
NONE	OG0009330	3	0	1	0	0	1	5
NONE	OG0009331	2	0	3	0	0	0	5
NONE	OG0009332	2	0	2	0	0	1	5
NONE	OG0009333	1	1	1	1	1	0	5
NONE	OG0009334	1	1	1	1	1	0	5
NONE	OG0009335	1	1	1	1	0	1	5
NONE	OG0009336	1	0	1	1	1	1	5
NONE	OG0009337	1	1	1	1	0	1	5
NONE	OG0009338	1	0	1	1	1	1	5
NONE	OG0009339	1	1	1	1	0	1	5
NONE	OG0009340	1	1	1	1	0	1	5
NONE	OG0009341	1	1	1	1	0	1	5
NONE	OG0009342	1	1	1	0	1	1	5
NONE	OG0009343	1	1	1	1	0	1	5
NONE	OG0009344	1	0	1	1	1	1	5
NONE	OG0009345	1	1	1	0	2	0	5
NONE	OG0009346	1	1	1	1	0	1	5
NONE	OG0009347	1	0	1	1	1	1	5
NONE	OG0009348	1	1	1	1	0	1	5
NONE	OG0009349	1	1	1	1	0	1	5
NONE	OG0009350	1	0	1	1	1	1	5
NONE	OG0009351	1	1	1	1	0	1	5
NONE	OG0009352	1	1	1	1	0	1	5
NONE	OG0009353	1	1	1	1	0	1	5
NONE	OG0009354	1	1	1	1	0	1	5
NONE	OG0009355	1	1	1	1	0	1	5
NONE	OG0009356	1	1	0	1	1	1	5
NONE	OG0009357	1	1	1	0	1	1	5
NONE	OG0009358	1	0	1	2	0	1	5
NONE	OG0009359	1	1	1	1	0	1	5
NONE	OG0009360	1	1	1	1	0	1	5
NONE	OG0009361	1	0	1	1	1	1	5
NONE	OG0009362	1	1	1	1	0	1	5
NONE	OG0009363	1	0	1	1	1	1	5
NONE	OG0009364	1	1	1	0	1	1	5
NONE	OG0009365	1	0	1	1	1	1	5
NONE	OG0009366	1	0	1	1	1	1	5
NONE	OG0009367	1	0	1	1	1	1	5
NONE	OG0009368	2	0	1	0	0	2	5
NONE	OG0009369	1	0	1	1	1	1	5
NONE	OG0009370	1	0	1	1	1	1	5
NONE	OG0009371	1	0	1	1	1	1	5
NONE	OG0009372	1	1	1	0	1	1	5
NONE	OG0009373	1	1	1	0	1	1	5
NONE	OG0009374	1	1	1	0	1	1	5
NONE	OG0009375	1	1	1	0	1	1	5
NONE	OG0009376	1	1	1	0	1	1	5
NONE	OG0009377	1	0	1	1	1	1	5
NONE	OG0009378	1	1	1	1	0	1	5
NONE	OG0009379	1	1	1	0	1	1	5
NONE	OG0009380	1	1	1	1	0	1	5
NONE	OG0009381	3	0	1	0	0	1	5
NONE	OG0009382	1	1	1	1	0	1	5
NONE	OG0009383	1	1	1	1	0	1	5
NONE	OG0009384	1	0	2	1	0	1	5
NONE	OG0009385	1	0	1	1	1	1	5
NONE	OG0009386	1	0	1	1	1	1	5
NONE	OG0009387	1	0	1	0	3	0	5
NONE	OG0009388	1	0	1	1	1	1	5
NONE	OG0009389	1	0	1	1	1	1	5
NONE	OG0009390	1	1	1	1	0	1	5
NONE	OG0009391	1	0	1	1	1	1	5
NONE	OG0009392	1	0	1	1	1	1	5
NONE	OG0009393	2	0	1	1	0	1	5
NONE	OG0009394	2	0	1	1	0	1	5
NONE	OG0009395	1	1	1	1	0	1	5
NONE	OG0009396	4	1	0	0	0	0	5
NONE	OG0009397	1	1	1	1	0	1	5
NONE	OG0009398	1	0	2	1	0	1	5
NONE	OG0009399	1	1	1	1	0	1	5
NONE	OG0009400	1	0	2	1	0	1	5
NONE	OG0009401	1	1	1	1	0	1	5
NONE	OG0009402	2	0	1	1	0	1	5
NONE	OG0009403	1	0	1	2	0	1	5
NONE	OG0009404	1	0	1	1	1	1	5
NONE	OG0009405	1	0	1	1	1	1	5
NONE	OG0009406	1	1	1	1	0	1	5
NONE	OG0009407	1	0	1	1	1	1	5
NONE	OG0009408	1	1	1	1	0	1	5
NONE	OG0009409	1	0	1	1	1	1	5
NONE	OG0009410	1	0	1	1	1	1	5
NONE	OG0009411	1	0	1	1	1	1	5
NONE	OG0009412	1	1	1	1	0	1	5
NONE	OG0009413	1	0	2	1	0	1	5
NONE	OG0009414	1	1	1	1	0	1	5
NONE	OG0009415	1	0	1	1	1	1	5
NONE	OG0009416	1	0	1	1	1	1	5
NONE	OG0009417	2	0	1	1	0	1	5
NONE	OG0009418	1	0	1	1	1	1	5
NONE	OG0009419	1	0	1	1	1	1	5
NONE	OG0009420	1	0	1	1	1	1	5
NONE	OG0009421	1	1	1	1	0	1	5
NONE	OG0009422	1	0	1	1	1	1	5
NONE	OG0009423	1	0	1	1	1	1	5
NONE	OG0009424	2	0	1	1	0	1	5
NONE	OG0009425	1	1	1	1	0	1	5
NONE	OG0009426	1	0	1	2	0	1	5
NONE	OG0009427	1	1	1	1	0	1	5
NONE	OG0009428	2	0	1	1	0	1	5
NONE	OG0009429	2	0	3	0	0	0	5
NONE	OG0009430	4	0	1	0	0	0	5
NONE	OG0009431	5	0	0	0	0	0	5
NONE	OG0009432	1	0	1	1	1	1	5
NONE	OG0009433	5	0	0	0	0	0	5
NONE	OG0009434	2	0	1	1	0	1	5
NONE	OG0009435	1	1	1	0	1	1	5
NONE	OG0009436	1	0	1	1	1	1	5
NONE	OG0009437	1	1	1	1	0	1	5
NONE	OG0009438	1	1	1	0	1	1	5
NONE	OG0009439	1	0	2	1	0	1	5
NONE	OG0009440	1	0	1	1	1	1	5
NONE	OG0009441	2	0	1	1	0	1	5
NONE	OG0009442	1	0	4	0	0	0	5
NONE	OG0009443	1	1	1	1	0	1	5
NONE	OG0009444	1	0	1	1	1	1	5
NONE	OG0009445	1	0	1	1	1	1	5
NONE	OG0009446	1	0	1	1	1	1	5
NONE	OG0009447	1	0	1	1	1	1	5
NONE	OG0009448	1	0	1	1	1	1	5
NONE	OG0009449	1	0	1	1	1	1	5
NONE	OG0009450	1	1	0	1	1	1	5
NONE	OG0009451	1	0	1	1	1	1	5
NONE	OG0009452	1	1	1	1	1	0	5
NONE	OG0009453	1	0	1	1	1	1	5
NONE	OG0009454	1	0	1	1	1	1	5
NONE	OG0009455	1	0	2	1	0	1	5
NONE	OG0009456	5	0	0	0	0	0	5
NONE	OG0009457	1	0	1	1	1	1	5
NONE	OG0009458	1	0	1	1	1	1	5
NONE	OG0009459	1	1	0	1	1	1	5
NONE	OG0009460	1	1	1	1	0	1	5
NONE	OG0009461	1	0	1	1	1	1	5
NONE	OG0009462	1	0	1	1	1	1	5
NONE	OG0009463	1	1	1	1	1	0	5
NONE	OG0009464	1	1	1	1	0	1	5
NONE	OG0009465	1	0	1	1	1	1	5
NONE	OG0009466	1	0	1	1	1	1	5
NONE	OG0009467	1	0	1	1	1	1	5
NONE	OG0009468	1	0	1	1	1	1	5
NONE	OG0009469	1	0	2	1	0	1	5
NONE	OG0009470	1	0	2	0	0	2	5
NONE	OG0009471	1	1	1	1	0	1	5
NONE	OG0009472	1	0	1	1	1	1	5
NONE	OG0009473	1	1	1	1	0	1	5
NONE	OG0009474	1	0	1	1	1	1	5
NONE	OG0009475	1	0	1	1	1	1	5
NONE	OG0009476	1	0	1	2	0	1	5
NONE	OG0009477	1	1	1	1	0	1	5
NONE	OG0009478	1	1	1	1	0	1	5
NONE	OG0009479	1	0	1	1	1	1	5
NONE	OG0009480	1	0	1	1	1	1	5
NONE	OG0009481	1	0	1	1	1	1	5
NONE	OG0009482	3	0	2	0	0	0	5
NONE	OG0009483	1	0	1	1	1	1	5
NONE	OG0009484	1	1	1	1	1	0	5
NONE	OG0009485	1	0	1	1	1	1	5
NONE	OG0009486	1	0	1	1	1	1	5
NONE	OG0009487	1	1	1	1	0	1	5
NONE	OG0009488	1	0	1	1	1	1	5
NONE	OG0009489	1	0	1	1	1	1	5
NONE	OG0009490	2	0	1	1	0	1	5
NONE	OG0009491	2	0	1	0	1	1	5
NONE	OG0009492	2	0	1	1	0	1	5
NONE	OG0009493	1	1	1	1	1	0	5
NONE	OG0009494	1	0	1	1	1	1	5
NONE	OG0009495	1	1	1	1	0	1	5
NONE	OG0009496	2	0	2	0	0	1	5
NONE	OG0009497	1	1	1	1	0	1	5
NONE	OG0009498	1	0	1	0	0	3	5
NONE	OG0009499	1	0	1	1	1	1	5
NONE	OG0009500	1	0	1	1	1	1	5
NONE	OG0009501	2	0	1	1	0	1	5
NONE	OG0009502	3	0	0	1	0	1	5
NONE	OG0009503	1	0	1	1	1	1	5
NONE	OG0009504	1	0	1	1	1	1	5
NONE	OG0009505	1	0	1	1	1	1	5
NONE	OG0009506	1	0	1	1	1	1	5
NONE	OG0009507	1	0	1	1	1	1	5
NONE	OG0009508	1	0	1	1	1	1	5
NONE	OG0009509	1	0	1	1	1	1	5
NONE	OG0009510	1	0	2	1	0	1	5
NONE	OG0009511	1	0	1	1	1	1	5
NONE	OG0009512	1	0	1	1	1	1	5
NONE	OG0009513	1	0	1	2	0	1	5
NONE	OG0009514	1	1	0	1	1	1	5
NONE	OG0009515	2	0	1	1	0	1	5
NONE	OG0009516	1	1	1	1	0	1	5
NONE	OG0009517	1	1	1	1	0	1	5
NONE	OG0009518	1	0	2	0	0	2	5
NONE	OG0009519	1	1	1	0	1	1	5
NONE	OG0009520	1	0	1	1	1	1	5
NONE	OG0009521	1	0	1	1	1	1	5
NONE	OG0009522	1	0	1	1	1	1	5
NONE	OG0009523	1	1	0	1	1	1	5
NONE	OG0009524	1	0	1	1	0	2	5
NONE	OG0009525	1	1	1	1	0	1	5
NONE	OG0009526	1	1	1	1	0	1	5
NONE	OG0009527	1	0	1	2	0	1	5
NONE	OG0009528	1	0	1	1	1	1	5
NONE	OG0009529	1	0	1	1	1	1	5
NONE	OG0009530	1	0	1	1	1	1	5
NONE	OG0009531	1	1	1	1	1	0	5
NONE	OG0009532	2	0	1	2	0	0	5
NONE	OG0009533	1	1	1	1	1	0	5
NONE	OG0009534	1	0	1	1	1	1	5
NONE	OG0009535	1	0	1	1	1	1	5
NONE	OG0009536	1	0	1	1	1	1	5
NONE	OG0009537	1	1	1	1	0	1	5
NONE	OG0009538	1	1	0	1	1	1	5
NONE	OG0009539	1	0	1	1	1	1	5
NONE	OG0009540	1	1	0	1	1	1	5
NONE	OG0009541	1	0	1	1	1	1	5
NONE	OG0009542	1	0	1	1	1	1	5
NONE	OG0009543	1	0	1	1	1	1	5
NONE	OG0009544	1	0	1	1	1	1	5
NONE	OG0009545	1	0	1	1	1	1	5
NONE	OG0009546	2	0	1	0	0	2	5
NONE	OG0009547	1	0	1	1	1	1	5
NONE	OG0009548	1	0	1	1	1	1	5
NONE	OG0009549	1	0	1	1	1	1	5
NONE	OG0009550	2	0	3	0	0	0	5
NONE	OG0009551	1	0	1	1	1	1	5
NONE	OG0009552	1	0	1	1	1	1	5
NONE	OG0009553	1	0	1	1	1	1	5
NONE	OG0009554	1	0	2	2	0	0	5
NONE	OG0009555	1	0	1	2	0	1	5
NONE	OG0009556	1	0	1	1	1	1	5
NONE	OG0009557	1	1	1	0	1	1	5
NONE	OG0009558	1	0	1	1	1	1	5
NONE	OG0009559	1	0	1	1	1	1	5
NONE	OG0009560	1	0	1	1	1	1	5
NONE	OG0009561	1	0	1	1	1	1	5
NONE	OG0009562	1	1	1	1	0	1	5
NONE	OG0009563	1	0	1	2	1	0	5
NONE	OG0009564	1	0	1	1	1	1	5
NONE	OG0009565	1	0	1	1	1	1	5
NONE	OG0009566	2	0	3	0	0	0	5
NONE	OG0009567	1	0	1	1	1	1	5
NONE	OG0009568	1	1	2	1	0	0	5
NONE	OG0009569	1	0	1	1	1	1	5
NONE	OG0009570	1	1	1	1	0	1	5
NONE	OG0009571	1	1	1	1	0	1	5
NONE	OG0009572	1	1	1	1	0	1	5
NONE	OG0009573	2	0	1	1	0	1	5
NONE	OG0009574	1	0	1	1	1	1	5
NONE	OG0009575	1	0	1	1	1	1	5
NONE	OG0009576	1	0	1	1	1	1	5
NONE	OG0009577	1	0	1	2	0	1	5
NONE	OG0009578	1	0	1	1	1	1	5
NONE	OG0009579	1	0	1	1	1	1	5
NONE	OG0009580	1	1	1	0	1	1	5
NONE	OG0009581	1	1	1	1	1	0	5
NONE	OG0009582	1	1	1	0	1	1	5
NONE	OG0009583	1	1	1	0	1	1	5
NONE	OG0009584	1	0	1	1	1	1	5
NONE	OG0009585	1	1	1	1	1	0	5
NONE	OG0009586	1	1	1	1	0	1	5
NONE	OG0009587	1	1	1	1	0	1	5
NONE	OG0009588	1	1	1	1	1	0	5
NONE	OG0009589	1	1	1	1	1	0	5
NONE	OG0009590	1	1	1	1	1	0	5
NONE	OG0009591	1	0	1	1	1	1	5
NONE	OG0009592	1	1	1	1	1	0	5
NONE	OG0009593	1	1	1	1	1	0	5
NONE	OG0009594	1	0	1	1	1	1	5
NONE	OG0009595	1	1	1	0	1	1	5
NONE	OG0009596	1	1	1	0	1	1	5
NONE	OG0009597	1	0	1	1	1	1	5
NONE	OG0009598	1	1	1	1	0	1	5
NONE	OG0009599	1	0	1	1	1	1	5
NONE	OG0009600	1	0	1	1	1	1	5
NONE	OG0009601	1	1	1	1	1	0	5
NONE	OG0009602	2	0	1	1	0	1	5
NONE	OG0009603	1	1	1	1	0	1	5
NONE	OG0009604	1	0	1	1	1	1	5
NONE	OG0009605	1	1	1	1	0	1	5
NONE	OG0009606	1	0	1	1	1	1	5
NONE	OG0009607	1	1	1	1	1	0	5
NONE	OG0009608	1	1	1	0	1	1	5
NONE	OG0009609	1	0	1	1	1	1	5
NONE	OG0009610	1	0	1	1	1	1	5
NONE	OG0009611	1	1	1	1	1	0	5
NONE	OG0009612	1	0	1	1	1	1	5
NONE	OG0009613	1	0	1	1	1	1	5
NONE	OG0009614	1	0	1	1	1	1	5
NONE	OG0009615	1	0	1	1	1	1	5
NONE	OG0009616	1	0	1	1	1	1	5
NONE	OG0009617	1	0	1	1	1	1	5
NONE	OG0009618	1	0	1	1	1	1	5
NONE	OG0009619	1	1	1	0	1	1	5
NONE	OG0009620	1	1	1	1	1	0	5
NONE	OG0009621	1	0	1	2	1	0	5
NONE	OG0009622	1	1	1	1	1	0	5
NONE	OG0009623	1	0	1	1	1	1	5
NONE	OG0009624	1	0	1	1	1	1	5
NONE	OG0009625	1	1	1	0	1	1	5
NONE	OG0009626	1	1	1	0	1	1	5
NONE	OG0009627	1	1	1	0	1	1	5
NONE	OG0009628	1	1	1	1	1	0	5
NONE	OG0009629	1	1	1	0	1	1	5
NONE	OG0009630	1	1	1	0	1	1	5
NONE	OG0009631	1	0	1	1	1	1	5
NONE	OG0009632	1	1	1	0	1	1	5
NONE	OG0009633	2	0	1	2	0	0	5
NONE	OG0009634	1	0	1	1	1	1	5
NONE	OG0009635	1	0	1	1	1	1	5
NONE	OG0009636	1	1	1	1	0	1	5
NONE	OG0009637	1	0	1	1	1	1	5
NONE	OG0009638	2	0	1	1	0	1	5
NONE	OG0009639	1	1	2	1	0	0	5
NONE	OG0009640	1	1	1	1	0	1	5
NONE	OG0009641	1	1	1	1	0	1	5
NONE	OG0009642	1	1	1	0	1	1	5
NONE	OG0009643	1	1	1	1	1	0	5
NONE	OG0009644	2	0	1	1	0	1	5
NONE	OG0009645	1	1	1	1	0	1	5
NONE	OG0009646	1	0	1	1	1	1	5
NONE	OG0009647	1	1	1	1	0	1	5
NONE	OG0009648	1	0	1	1	1	1	5
NONE	OG0009649	1	0	1	1	1	1	5
NONE	OG0009650	1	1	1	1	0	1	5
NONE	OG0009651	1	1	1	1	0	1	5
NONE	OG0009652	1	0	1	1	1	1	5
NONE	OG0009653	1	1	1	1	0	1	5
NONE	OG0009654	1	0	1	1	1	1	5
NONE	OG0009655	1	0	1	1	1	1	5
NONE	OG0009656	1	1	1	1	0	1	5
NONE	OG0009657	1	1	1	0	1	1	5
NONE	OG0009658	1	1	1	0	1	1	5
NONE	OG0009659	1	1	1	1	1	0	5
NONE	OG0009660	1	1	1	1	1	0	5
NONE	OG0009661	1	0	1	1	1	1	5
NONE	OG0009662	1	0	1	1	1	1	5
NONE	OG0009663	1	0	1	1	1	1	5
NONE	OG0009664	1	0	1	1	1	1	5
NONE	OG0009665	1	0	1	1	1	1	5
NONE	OG0009666	1	1	1	1	0	1	5
NONE	OG0009667	1	1	1	1	0	1	5
NONE	OG0009668	1	1	0	0	0	3	5
NONE	OG0009669	2	0	1	1	0	1	5
NONE	OG0009670	1	0	1	1	1	1	5
NONE	OG0009671	1	0	3	0	0	1	5
NONE	OG0009672	1	1	1	1	0	1	5
NONE	OG0009673	1	0	2	1	0	1	5
NONE	OG0009674	1	0	1	1	1	1	5
NONE	OG0009675	1	0	1	1	1	1	5
NONE	OG0009676	1	0	1	1	1	1	5
NONE	OG0009677	1	1	1	1	1	0	5
NONE	OG0009678	1	1	1	1	1	0	5
NONE	OG0009679	1	0	1	1	1	1	5
NONE	OG0009680	1	1	1	1	0	1	5
NONE	OG0009681	1	0	1	1	1	1	5
NONE	OG0009682	1	0	1	1	1	1	5
NONE	OG0009683	1	0	1	1	1	1	5
NONE	OG0009684	1	1	1	1	0	1	5
NONE	OG0009685	1	1	1	1	0	1	5
NONE	OG0009686	1	1	1	1	0	1	5
NONE	OG0009687	1	0	1	1	1	1	5
NONE	OG0009688	1	0	2	1	0	1	5
NONE	OG0009689	1	0	1	1	1	1	5
NONE	OG0009690	1	0	1	2	0	1	5
NONE	OG0009691	1	0	1	2	0	1	5
NONE	OG0009692	1	0	1	1	1	1	5
NONE	OG0009693	1	1	1	1	0	1	5
NONE	OG0009694	1	0	1	1	1	1	5
NONE	OG0009695	1	0	1	1	1	1	5
NONE	OG0009696	1	0	1	1	1	1	5
NONE	OG0009697	1	1	1	1	0	1	5
NONE	OG0009698	1	1	1	1	0	1	5
NONE	OG0009699	1	0	1	1	1	1	5
NONE	OG0009700	1	0	1	1	1	1	5
NONE	OG0009701	1	1	1	1	0	1	5
NONE	OG0009702	1	0	1	1	1	1	5
NONE	OG0009703	1	1	1	1	0	1	5
NONE	OG0009704	1	1	1	1	0	1	5
NONE	OG0009705	1	1	1	1	0	1	5
NONE	OG0009706	3	0	1	0	0	1	5
NONE	OG0009707	1	1	1	1	0	1	5
NONE	OG0009708	1	0	1	1	1	1	5
NONE	OG0009709	1	0	1	1	1	1	5
NONE	OG0009710	2	0	1	1	0	1	5
NONE	OG0009711	1	0	4	0	0	0	5
NONE	OG0009712	1	0	1	1	1	1	5
NONE	OG0009713	1	1	1	1	0	1	5
NONE	OG0009714	1	1	1	1	0	1	5
NONE	OG0009715	1	1	1	1	0	1	5
NONE	OG0009716	1	0	1	1	1	1	5
NONE	OG0009717	1	1	1	1	1	0	5
NONE	OG0009718	1	1	1	1	1	0	5
NONE	OG0009719	1	0	1	1	1	1	5
NONE	OG0009720	2	0	1	0	0	2	5
NONE	OG0009721	1	0	1	1	1	1	5
NONE	OG0009722	1	1	1	1	0	1	5
NONE	OG0009723	1	0	1	1	1	1	5
NONE	OG0009724	1	0	1	1	1	1	5
NONE	OG0009725	1	1	1	0	1	1	5
NONE	OG0009726	1	0	1	1	1	1	5
NONE	OG0009727	1	0	1	1	1	1	5
NONE	OG0009728	1	0	1	1	1	1	5
NONE	OG0009729	1	0	1	1	1	1	5
NONE	OG0009730	1	1	1	1	0	1	5
NONE	OG0009731	1	0	1	1	1	1	5
NONE	OG0009732	1	1	1	1	0	1	5
NONE	OG0009733	1	0	1	1	1	1	5
NONE	OG0009734	1	0	1	1	1	1	5
NONE	OG0009735	1	0	1	1	1	1	5
NONE	OG0009736	1	1	1	1	0	1	5
NONE	OG0009737	1	1	1	1	0	1	5
NONE	OG0009738	1	1	1	0	1	1	5
NONE	OG0009739	1	1	1	0	1	1	5
NONE	OG0009740	1	1	1	0	1	1	5
NONE	OG0009741	1	1	1	0	1	1	5
NONE	OG0009742	1	0	1	1	1	1	5
NONE	OG0009743	1	0	1	1	1	1	5
NONE	OG0009744	1	0	1	1	1	1	5
NONE	OG0009745	1	0	1	1	1	1	5
NONE	OG0009746	1	0	1	1	1	1	5
NONE	OG0009747	2	0	2	1	0	0	5
NONE	OG0009748	1	0	1	1	1	1	5
NONE	OG0009749	1	1	1	1	0	1	5
NONE	OG0009750	1	0	1	1	1	1	5
NONE	OG0009751	1	1	1	0	1	1	5
NONE	OG0009752	1	1	1	0	1	1	5
NONE	OG0009753	1	0	2	0	1	1	5
NONE	OG0009754	1	1	1	1	0	1	5
NONE	OG0009755	1	0	1	1	1	1	5
NONE	OG0009756	1	0	1	1	1	1	5
NONE	OG0009757	5	0	0	0	0	0	5
NONE	OG0009758	1	0	1	1	1	1	5
NONE	OG0009759	1	1	1	0	1	1	5
NONE	OG0009760	1	0	1	1	1	1	5
NONE	OG0009761	2	0	1	1	0	1	5
NONE	OG0009762	1	1	1	1	0	1	5
NONE	OG0009763	2	0	1	1	0	1	5
NONE	OG0009764	1	1	1	1	0	1	5
NONE	OG0009765	1	1	1	1	0	1	5
NONE	OG0009766	1	1	1	0	1	1	5
NONE	OG0009767	1	0	0	0	0	4	5
NONE	OG0009768	1	1	1	1	0	1	5
NONE	OG0009769	1	1	1	1	0	1	5
NONE	OG0009770	1	1	1	1	0	1	5
NONE	OG0009771	1	1	1	1	0	1	5
NONE	OG0009772	1	0	1	1	1	1	5
NONE	OG0009773	1	0	1	1	1	1	5
NONE	OG0009774	1	0	1	1	1	1	5
NONE	OG0009775	1	0	1	1	1	1	5
NONE	OG0009776	1	0	2	1	0	1	5
NONE	OG0009777	1	1	1	0	1	1	5
NONE	OG0009778	1	0	1	1	1	1	5
NONE	OG0009779	1	0	1	1	1	1	5
NONE	OG0009780	2	0	2	0	0	1	5
NONE	OG0009781	1	0	1	1	1	1	5
NONE	OG0009782	1	1	1	0	1	1	5
NONE	OG0009783	1	1	2	0	0	1	5
NONE	OG0009784	1	1	1	0	1	1	5
NONE	OG0009785	1	1	2	0	0	1	5
NONE	OG0009786	1	1	1	1	0	1	5
NONE	OG0009787	1	1	1	1	1	0	5
NONE	OG0009788	1	0	1	1	1	1	5
NONE	OG0009789	1	0	1	1	1	1	5
NONE	OG0009790	2	0	1	1	0	1	5
NONE	OG0009791	1	0	1	1	1	1	5
NONE	OG0009792	1	0	2	1	0	1	5
NONE	OG0009793	1	0	4	0	0	0	5
NONE	OG0009794	1	0	1	2	0	1	5
NONE	OG0009795	1	0	1	2	0	1	5
NONE	OG0009796	1	0	1	1	1	1	5
NONE	OG0009797	1	1	1	1	0	1	5
NONE	OG0009798	1	1	1	1	0	1	5
NONE	OG0009799	1	1	1	1	0	1	5
NONE	OG0009800	2	0	1	1	0	1	5
NONE	OG0009801	1	0	1	1	0	2	5
NONE	OG0009802	1	0	1	1	1	1	5
NONE	OG0009803	1	0	1	1	1	1	5
NONE	OG0009804	1	1	1	0	1	1	5
NONE	OG0009805	1	0	1	1	1	1	5
NONE	OG0009806	1	0	1	1	1	1	5
NONE	OG0009807	1	1	1	1	0	1	5
NONE	OG0009808	1	1	1	1	0	1	5
NONE	OG0009809	1	0	1	1	1	1	5
NONE	OG0009810	1	0	1	1	1	1	5
NONE	OG0009811	1	0	1	1	1	1	5
NONE	OG0009812	1	1	1	1	1	0	5
NONE	OG0009813	1	1	1	1	0	1	5
NONE	OG0009814	1	0	1	2	0	1	5
NONE	OG0009815	3	0	1	1	0	0	5
NONE	OG0009816	4	0	0	1	0	0	5
NONE	OG0009817	4	0	0	1	0	0	5
NONE	OG0009818	3	0	2	0	0	0	5
NONE	OG0009819	4	0	1	0	0	0	5
NONE	OG0009820	1	1	1	1	0	1	5
NONE	OG0009821	1	0	1	1	1	1	5
NONE	OG0009822	1	0	1	1	1	1	5
NONE	OG0009823	2	0	1	0	1	1	5
NONE	OG0009824	1	0	1	1	1	1	5
NONE	OG0009825	1	1	1	0	1	1	5
NONE	OG0009826	1	1	1	0	1	1	5
NONE	OG0009827	1	1	1	0	1	1	5
NONE	OG0009828	1	1	1	0	1	1	5
NONE	OG0009829	1	1	1	0	1	1	5
NONE	OG0009830	1	0	2	0	0	2	5
NONE	OG0009831	1	0	3	0	0	1	5
NONE	OG0009832	1	1	1	0	1	1	5
NONE	OG0009833	1	1	1	0	1	1	5
NONE	OG0009834	1	1	1	0	1	1	5
NONE	OG0009835	1	1	1	0	1	1	5
NONE	OG0009836	1	1	1	0	1	1	5
NONE	OG0009837	1	1	1	0	1	1	5
NONE	OG0009838	1	1	1	0	1	1	5
NONE	OG0009839	1	1	1	0	1	1	5
NONE	OG0009840	1	1	1	0	1	1	5
NONE	OG0009841	1	1	1	0	1	1	5
NONE	OG0009842	1	0	2	1	0	1	5
NONE	OG0009843	1	1	1	1	0	1	5
NONE	OG0009844	1	1	1	1	0	1	5
NONE	OG0009845	1	0	1	1	1	1	5
NONE	OG0009846	1	0	1	1	1	1	5
NONE	OG0009847	1	1	1	0	1	1	5
NONE	OG0009848	1	0	1	1	1	1	5
NONE	OG0009849	1	0	1	1	1	1	5
NONE	OG0009850	1	0	1	1	1	1	5
NONE	OG0009851	1	0	1	1	1	1	5
NONE	OG0009852	1	0	1	1	1	1	5
NONE	OG0009853	1	0	1	1	1	1	5
NONE	OG0009854	1	0	1	1	1	1	5
NONE	OG0009855	1	1	1	1	0	1	5
NONE	OG0009856	2	1	1	0	0	1	5
NONE	OG0009857	1	1	2	1	0	0	5
NONE	OG0009858	1	1	1	1	0	1	5
NONE	OG0009859	1	0	1	1	1	1	5
NONE	OG0009860	1	0	1	2	0	1	5
NONE	OG0009861	1	0	1	2	0	1	5
NONE	OG0009862	1	0	1	2	0	1	5
NONE	OG0009863	1	1	1	1	0	1	5
NONE	OG0009864	1	0	1	1	1	1	5
NONE	OG0009865	1	1	1	1	0	1	5
NONE	OG0009866	1	0	1	1	1	1	5
NONE	OG0009867	1	0	1	1	1	1	5
NONE	OG0009868	1	1	1	1	0	1	5
NONE	OG0009869	1	1	1	1	0	1	5
NONE	OG0009870	1	1	1	1	0	1	5
NONE	OG0009871	1	0	1	1	1	1	5
NONE	OG0009872	1	1	1	1	0	1	5
NONE	OG0009873	1	0	1	2	0	1	5
NONE	OG0009874	2	0	1	1	0	1	5
NONE	OG0009875	1	0	1	1	1	1	5
NONE	OG0009876	1	1	1	1	0	1	5
NONE	OG0009877	1	0	1	1	1	1	5
NONE	OG0009878	1	0	1	1	1	1	5
NONE	OG0009879	1	0	1	2	0	1	5
NONE	OG0009880	3	0	2	0	0	0	5
NONE	OG0009881	1	0	1	1	1	1	5
NONE	OG0009882	1	0	1	1	1	1	5
NONE	OG0009883	1	0	1	1	1	1	5
NONE	OG0009884	1	0	1	1	1	1	5
NONE	OG0009885	1	1	1	1	0	1	5
NONE	OG0009886	1	1	1	1	0	1	5
NONE	OG0009887	1	0	1	1	1	1	5
NONE	OG0009888	1	1	0	1	1	1	5
NONE	OG0009889	1	1	1	1	0	1	5
NONE	OG0009890	1	0	1	1	1	1	5
NONE	OG0009891	1	0	1	1	1	1	5
NONE	OG0009892	1	1	1	1	0	1	5
NONE	OG0009893	1	0	2	2	0	0	5
NONE	OG0009894	1	0	2	1	0	1	5
NONE	OG0009895	1	0	1	1	1	1	5
NONE	OG0009896	1	0	1	2	0	1	5
NONE	OG0009897	1	0	1	1	1	1	5
NONE	OG0009898	1	0	4	0	0	0	5
NONE	OG0009899	1	1	1	1	1	0	5
NONE	OG0009900	1	0	1	2	0	1	5
NONE	OG0009901	1	1	1	1	0	1	5
NONE	OG0009902	1	1	1	1	0	1	5
NONE	OG0009903	1	1	1	1	0	1	5
NONE	OG0009904	1	1	1	1	0	1	5
NONE	OG0009905	1	0	2	1	0	1	5
NONE	OG0009906	1	0	1	1	1	1	5
NONE	OG0009907	1	0	1	1	1	1	5
NONE	OG0009908	1	0	1	1	1	1	5
NONE	OG0009909	1	1	1	1	0	1	5
NONE	OG0009910	1	1	1	1	0	1	5
NONE	OG0009911	1	1	1	1	0	1	5
NONE	OG0009912	1	0	1	1	1	1	5
NONE	OG0009913	5	0	0	0	0	0	5
NONE	OG0009914	1	0	1	1	1	1	5
NONE	OG0009915	1	0	1	1	1	1	5
NONE	OG0009916	1	0	1	1	1	1	5
NONE	OG0009917	1	1	1	1	0	1	5
NONE	OG0009918	5	0	0	0	0	0	5
NONE	OG0009919	3	0	2	0	0	0	5
NONE	OG0009920	1	1	1	1	1	0	5
NONE	OG0009921	1	1	1	1	1	0	5
NONE	OG0009922	1	1	1	2	0	0	5
NONE	OG0009923	1	1	1	2	0	0	5
NONE	OG0009924	5	0	0	0	0	0	5
NONE	OG0009925	4	0	1	0	0	0	5
NONE	OG0009926	1	1	1	1	1	0	5
NONE	OG0009927	1	1	1	1	1	0	5
NONE	OG0009928	1	1	1	1	1	0	5
NONE	OG0009929	1	0	3	1	0	0	5
NONE	OG0009930	1	1	1	1	1	0	5
NONE	OG0009931	1	1	1	1	1	0	5
NONE	OG0009932	1	1	1	1	1	0	5
NONE	OG0009933	1	1	1	1	1	0	5
NONE	OG0009934	1	1	1	1	1	0	5
NONE	OG0009935	1	0	1	1	1	1	5
NONE	OG0009936	1	1	1	1	1	0	5
NONE	OG0009937	1	1	1	1	1	0	5
NONE	OG0009938	1	1	0	1	1	1	5
NONE	OG0009939	1	0	1	1	1	1	5
NONE	OG0009940	1	1	1	1	0	1	5
NONE	OG0009941	1	1	1	1	0	1	5
NONE	OG0009942	1	0	1	1	1	1	5
NONE	OG0009943	1	1	1	1	0	1	5
NONE	OG0009944	1	0	1	1	1	1	5
NONE	OG0009945	1	0	1	1	1	1	5
NONE	OG0009946	1	0	1	1	1	1	5
NONE	OG0009947	1	1	1	1	0	1	5
NONE	OG0009948	1	0	1	2	0	1	5
NONE	OG0009949	1	1	1	1	0	1	5
NONE	OG0009950	1	1	1	1	0	1	5
NONE	OG0009951	1	0	1	1	1	1	5
NONE	OG0009952	1	0	1	1	1	1	5
NONE	OG0009953	1	1	1	1	0	1	5
NONE	OG0009954	1	0	1	1	1	1	5
NONE	OG0009955	2	0	1	1	0	1	5
NONE	OG0009956	2	0	1	1	0	1	5
NONE	OG0009957	1	1	1	1	0	1	5
NONE	OG0009958	1	1	1	1	1	0	5
NONE	OG0009959	1	0	1	1	1	1	5
NONE	OG0009960	1	1	1	1	0	1	5
NONE	OG0009961	1	0	1	2	0	1	5
NONE	OG0009962	1	0	1	1	1	1	5
NONE	OG0009963	1	1	1	1	0	1	5
NONE	OG0009964	1	0	1	1	1	1	5
NONE	OG0009965	1	0	1	1	1	1	5
NONE	OG0009966	1	0	1	1	1	1	5
NONE	OG0009967	1	1	1	1	0	1	5
NONE	OG0009968	1	0	1	1	1	1	5
NONE	OG0009969	1	1	1	1	0	1	5
NONE	OG0009970	1	0	2	0	2	0	5
NONE	OG0009971	1	1	1	1	0	1	5
NONE	OG0009972	1	0	1	1	1	1	5
NONE	OG0009973	1	0	1	1	1	1	5
NONE	OG0009974	1	0	1	1	1	1	5
NONE	OG0009975	1	0	1	1	1	1	5
NONE	OG0009976	1	0	1	1	1	1	5
NONE	OG0009977	1	0	1	1	1	1	5
NONE	OG0009978	1	0	1	1	1	1	5
NONE	OG0009979	1	0	1	1	1	1	5
NONE	OG0009980	1	0	1	1	1	1	5
NONE	OG0009981	1	0	1	1	1	1	5
NONE	OG0009982	1	0	1	1	1	1	5
NONE	OG0009983	1	0	1	1	1	1	5
NONE	OG0009984	1	0	1	1	1	1	5
NONE	OG0009985	1	0	1	1	1	1	5
NONE	OG0009986	1	1	1	0	1	1	5
NONE	OG0009987	1	1	1	0	1	1	5
NONE	OG0009988	1	1	1	0	1	1	5
NONE	OG0009989	1	1	1	0	1	1	5
NONE	OG0009990	1	1	1	0	1	1	5
NONE	OG0009991	1	1	1	0	1	1	5
NONE	OG0009992	1	0	1	1	1	1	5
NONE	OG0009993	1	1	1	0	1	1	5
NONE	OG0009994	1	1	1	1	0	1	5
NONE	OG0009995	1	0	1	1	1	1	5
NONE	OG0009996	1	0	1	1	1	1	5
NONE	OG0009997	1	1	1	1	0	1	5
NONE	OG0009998	2	0	1	1	0	1	5
NONE	OG0009999	1	0	1	1	1	1	5
NONE	OG0010000	1	0	1	1	1	1	5
NONE	OG0010001	1	1	1	1	0	1	5
NONE	OG0010002	1	0	1	1	1	1	5
NONE	OG0010003	1	1	0	1	1	1	5
NONE	OG0010004	1	0	1	1	1	1	5
NONE	OG0010005	1	0	1	1	1	1	5
NONE	OG0010006	1	0	1	1	1	1	5
NONE	OG0010007	1	0	1	1	1	1	5
NONE	OG0010008	1	0	1	1	1	1	5
NONE	OG0010009	1	0	1	1	1	1	5
NONE	OG0010010	1	0	1	1	1	1	5
NONE	OG0010011	1	0	1	1	0	2	5
NONE	OG0010012	1	0	1	1	1	1	5
NONE	OG0010013	1	1	1	1	0	1	5
NONE	OG0010014	1	0	2	1	0	1	5
NONE	OG0010015	1	0	1	1	1	1	5
NONE	OG0010016	1	0	1	1	1	1	5
NONE	OG0010017	1	0	1	1	1	1	5
NONE	OG0010018	1	0	1	1	1	1	5
NONE	OG0010019	1	0	1	1	1	1	5
NONE	OG0010020	1	0	1	1	1	1	5
NONE	OG0010021	1	1	1	1	0	1	5
NONE	OG0010022	1	0	1	1	1	1	5
NONE	OG0010023	1	0	1	1	1	1	5
NONE	OG0010024	1	0	1	1	1	1	5
NONE	OG0010025	1	0	1	1	1	1	5
NONE	OG0010026	1	1	1	1	0	1	5
NONE	OG0010027	1	0	1	1	1	1	5
NONE	OG0010028	1	0	2	1	0	1	5
NONE	OG0010029	1	0	1	1	1	1	5
NONE	OG0010030	1	1	0	1	1	1	5
NONE	OG0010031	1	0	1	0	2	1	5
NONE	OG0010032	1	0	1	1	1	1	5
NONE	OG0010033	1	0	4	0	0	0	5
NONE	OG0010034	1	0	1	1	0	2	5
NONE	OG0010035	1	0	2	1	0	1	5
NONE	OG0010036	1	1	1	1	0	1	5
NONE	OG0010037	1	1	1	1	0	1	5
NONE	OG0010038	1	0	1	1	1	1	5
NONE	OG0010039	1	1	1	1	0	1	5
NONE	OG0010040	1	1	1	1	0	1	5
NONE	OG0010041	1	1	1	1	0	1	5
NONE	OG0010042	1	0	1	2	0	1	5
NONE	OG0010043	1	1	1	1	0	1	5
NONE	OG0010044	1	0	1	1	1	1	5
NONE	OG0010045	1	1	1	1	1	0	5
NONE	OG0010046	2	0	2	0	1	0	5
NONE	OG0010047	1	0	2	1	0	1	5
NONE	OG0010048	1	0	1	1	1	1	5
NONE	OG0010049	1	0	1	1	1	1	5
NONE	OG0010050	1	0	1	1	0	2	5
NONE	OG0010051	1	1	1	1	0	1	5
NONE	OG0010052	1	0	1	1	1	1	5
NONE	OG0010053	1	1	1	1	0	1	5
NONE	OG0010054	1	1	1	1	0	1	5
NONE	OG0010055	1	0	1	2	0	1	5
NONE	OG0010056	1	0	1	1	1	1	5
NONE	OG0010057	1	1	1	0	1	1	5
NONE	OG0010058	1	2	1	0	0	1	5
NONE	OG0010059	1	0	1	1	1	1	5
NONE	OG0010060	1	1	1	1	0	1	5
NONE	OG0010061	1	0	1	1	1	1	5
NONE	OG0010062	1	0	1	1	1	1	5
NONE	OG0010063	1	1	1	1	0	1	5
NONE	OG0010064	1	0	1	1	1	1	5
NONE	OG0010065	1	1	1	1	1	0	5
NONE	OG0010066	2	0	1	1	1	0	5
NONE	OG0010067	1	1	1	1	1	0	5
NONE	OG0010068	1	1	1	1	1	0	5
NONE	OG0010069	1	0	1	1	1	1	5
NONE	OG0010070	1	0	1	1	1	1	5
NONE	OG0010071	1	0	1	1	1	1	5
NONE	OG0010072	1	1	1	1	0	1	5
NONE	OG0010073	2	0	1	1	0	1	5
NONE	OG0010074	1	0	1	1	1	1	5
NONE	OG0010075	1	1	1	1	0	1	5
NONE	OG0010076	1	1	1	1	0	1	5
NONE	OG0010077	1	0	1	1	1	1	5
NONE	OG0010078	1	1	1	1	0	1	5
NONE	OG0010079	1	1	1	1	0	1	5
NONE	OG0010080	1	0	1	1	1	1	5
NONE	OG0010081	1	1	1	1	0	1	5
NONE	OG0010082	1	1	1	1	0	1	5
NONE	OG0010083	1	1	1	1	0	1	5
NONE	OG0010084	1	0	1	1	1	1	5
NONE	OG0010085	1	0	1	1	1	1	5
NONE	OG0010086	1	0	1	2	0	1	5
NONE	OG0010087	1	0	1	2	0	1	5
NONE	OG0010088	1	0	1	2	0	1	5
NONE	OG0010089	1	1	1	0	1	1	5
NONE	OG0010090	2	0	3	0	0	0	5
NONE	OG0010091	2	0	1	2	0	0	5
NONE	OG0010092	1	1	1	1	0	1	5
NONE	OG0010093	1	1	1	0	1	1	5
NONE	OG0010094	1	1	1	0	1	1	5
NONE	OG0010095	1	1	1	1	0	1	5
NONE	OG0010096	1	0	1	1	1	1	5
NONE	OG0010097	1	1	1	1	0	1	5
NONE	OG0010098	1	0	1	1	1	1	5
NONE	OG0010099	1	1	1	1	0	1	5
NONE	OG0010100	1	1	1	1	0	1	5
NONE	OG0010101	1	1	1	1	0	1	5
NONE	OG0010102	1	1	1	1	0	1	5
NONE	OG0010103	1	1	1	1	0	1	5
NONE	OG0010104	1	1	1	1	0	1	5
NONE	OG0010105	1	0	2	0	0	2	5
NONE	OG0010106	1	0	1	1	0	2	5
NONE	OG0010107	1	1	1	1	0	1	5
NONE	OG0010108	1	0	1	2	0	1	5
NONE	OG0010109	1	0	2	1	0	1	5
NONE	OG0010110	1	0	1	1	1	1	5
NONE	OG0010111	1	0	1	1	1	1	5
NONE	OG0010112	1	0	1	1	1	1	5
NONE	OG0010113	1	1	1	1	0	1	5
NONE	OG0010114	2	0	1	1	0	1	5
NONE	OG0010115	1	0	1	1	1	1	5
NONE	OG0010116	1	0	1	1	1	1	5
NONE	OG0010117	1	0	1	1	1	1	5
NONE	OG0010118	1	1	1	1	0	1	5
NONE	OG0010119	1	0	1	1	1	1	5
NONE	OG0010120	1	1	1	1	0	1	5
NONE	OG0010121	1	1	1	2	0	0	5
NONE	OG0010122	1	0	1	1	1	1	5
NONE	OG0010123	1	0	1	1	1	1	5
NONE	OG0010124	4	0	1	0	0	0	5
NONE	OG0010125	1	0	1	1	1	1	5
NONE	OG0010126	1	1	1	0	1	1	5
NONE	OG0010127	1	1	1	1	0	1	5
NONE	OG0010128	1	1	1	1	0	1	5
NONE	OG0010129	1	1	1	1	0	1	5
NONE	OG0010130	1	1	1	1	0	1	5
NONE	OG0010131	1	1	1	1	0	1	5
NONE	OG0010132	1	0	1	3	0	0	5
NONE	OG0010133	1	0	1	1	1	1	5
NONE	OG0010134	1	0	1	1	1	1	5
NONE	OG0010135	1	1	1	1	0	1	5
NONE	OG0010136	1	1	1	1	0	1	5
NONE	OG0010137	1	0	1	1	1	1	5
NONE	OG0010138	1	1	1	1	0	1	5
NONE	OG0010139	1	0	1	1	1	1	5
NONE	OG0010140	1	0	1	1	1	1	5
NONE	OG0010141	2	0	1	1	0	1	5
NONE	OG0010142	1	1	1	1	0	1	5
NONE	OG0010143	1	1	1	1	0	1	5
NONE	OG0010144	1	1	1	1	0	1	5
NONE	OG0010145	1	1	1	1	0	1	5
NONE	OG0010146	1	1	1	1	0	1	5
NONE	OG0010147	1	0	1	1	1	1	5
NONE	OG0010148	1	0	1	1	1	1	5
NONE	OG0010149	1	1	1	1	0	1	5
NONE	OG0010150	1	1	1	1	0	1	5
NONE	OG0010151	1	0	1	1	1	1	5
NONE	OG0010152	1	0	1	1	1	1	5
NONE	OG0010153	1	0	2	1	0	1	5
NONE	OG0010154	1	0	1	1	1	1	5
NONE	OG0010155	1	0	1	1	1	1	5
NONE	OG0010156	1	1	1	0	1	1	5
NONE	OG0010157	1	0	1	1	1	1	5
NONE	OG0010158	1	1	1	1	0	1	5
NONE	OG0010159	1	0	1	2	0	1	5
NONE	OG0010160	1	1	1	1	0	1	5
NONE	OG0010161	1	0	1	1	1	1	5
NONE	OG0010162	1	0	1	1	1	1	5
NONE	OG0010163	1	1	1	1	0	1	5
NONE	OG0010164	1	0	1	1	1	1	5
NONE	OG0010165	1	0	1	1	1	1	5
NONE	OG0010166	1	0	1	1	1	1	5
NONE	OG0010167	1	0	2	1	0	1	5
NONE	OG0010168	1	0	1	1	1	1	5
NONE	OG0010169	1	0	1	1	1	1	5
NONE	OG0010170	1	1	1	1	0	1	5
NONE	OG0010171	1	1	1	1	0	1	5
NONE	OG0010172	1	1	1	1	0	1	5
NONE	OG0010173	1	0	1	1	1	1	5
NONE	OG0010174	1	0	1	1	1	1	5
NONE	OG0010175	1	1	1	1	0	1	5
NONE	OG0010176	1	1	1	1	0	1	5
NONE	OG0010177	1	1	1	1	0	1	5
NONE	OG0010178	1	1	1	1	0	1	5
NONE	OG0010179	1	1	1	1	0	1	5
NONE	OG0010180	1	1	1	1	0	1	5
NONE	OG0010181	1	0	1	1	1	1	5
NONE	OG0010182	1	1	1	1	0	1	5
NONE	OG0010183	1	1	1	1	0	1	5
NONE	OG0010184	1	0	1	1	1	1	5
NONE	OG0010185	1	0	3	0	0	1	5
NONE	OG0010186	1	0	1	1	1	1	5
NONE	OG0010187	1	1	1	1	0	1	5
NONE	OG0010188	1	1	1	1	0	1	5
NONE	OG0010189	2	0	1	1	0	1	5
NONE	OG0010190	1	1	1	1	0	1	5
NONE	OG0010191	1	0	1	1	1	1	5
NONE	OG0010192	1	0	1	1	1	1	5
NONE	OG0010193	1	0	4	0	0	0	5
NONE	OG0010194	1	1	1	1	0	1	5
NONE	OG0010195	1	1	1	0	1	1	5
NONE	OG0010196	2	0	1	0	1	1	5
NONE	OG0010197	1	1	1	1	0	1	5
NONE	OG0010198	1	1	1	1	0	1	5
NONE	OG0010199	1	0	1	0	0	3	5
NONE	OG0010200	1	1	1	1	0	1	5
NONE	OG0010201	1	0	1	1	1	1	5
NONE	OG0010202	1	0	1	1	1	1	5
NONE	OG0010203	1	0	1	1	1	1	5
NONE	OG0010204	3	0	2	0	0	0	5
NONE	OG0010205	1	0	1	1	1	1	5
NONE	OG0010206	1	1	0	1	0	2	5
NONE	OG0010207	1	0	1	1	1	1	5
NONE	OG0010208	1	0	1	1	1	1	5
NONE	OG0010209	1	0	1	1	0	2	5
NONE	OG0010210	1	1	1	1	0	1	5
NONE	OG0010211	1	1	1	1	0	1	5
NONE	OG0010212	1	0	1	1	1	1	5
NONE	OG0010213	1	1	1	1	0	1	5
NONE	OG0010214	1	1	2	1	0	0	5
NONE	OG0010215	1	1	1	1	0	1	5
NONE	OG0010216	1	1	1	0	1	1	5
NONE	OG0010217	1	1	1	1	0	1	5
NONE	OG0010218	1	1	1	1	0	1	5
NONE	OG0010219	1	1	1	1	0	1	5
NONE	OG0010220	1	0	1	1	1	1	5
NONE	OG0010221	1	1	1	0	1	1	5
NONE	OG0010222	1	1	1	0	1	1	5
NONE	OG0010223	1	1	1	0	1	1	5
NONE	OG0010224	1	1	1	0	1	1	5
NONE	OG0010225	1	1	1	0	1	1	5
NONE	OG0010226	1	1	1	0	1	1	5
NONE	OG0010227	1	1	1	0	1	1	5
NONE	OG0010228	1	1	1	0	1	1	5
NONE	OG0010229	1	0	1	1	1	1	5
NONE	OG0010230	1	0	1	1	1	1	5
NONE	OG0010231	1	1	1	0	1	1	5
NONE	OG0010232	1	1	1	0	1	1	5
NONE	OG0010233	1	1	1	0	1	1	5
NONE	OG0010234	1	1	1	0	1	1	5
NONE	OG0010235	1	1	1	0	1	1	5
NONE	OG0010236	1	1	1	0	1	1	5
NONE	OG0010237	1	1	1	0	1	1	5
NONE	OG0010238	1	1	1	0	1	1	5
NONE	OG0010239	1	1	1	0	1	1	5
NONE	OG0010240	1	1	1	0	1	1	5
NONE	OG0010241	1	1	1	0	1	1	5
NONE	OG0010242	1	1	1	0	1	1	5
NONE	OG0010243	1	1	1	0	1	1	5
NONE	OG0010244	1	1	1	0	1	1	5
NONE	OG0010245	1	0	1	1	1	1	5
NONE	OG0010246	1	1	1	0	1	1	5
NONE	OG0010247	1	1	1	0	1	1	5
NONE	OG0010248	1	1	1	0	1	1	5
NONE	OG0010249	1	1	1	0	1	1	5
NONE	OG0010250	1	1	1	0	1	1	5
NONE	OG0010251	1	0	1	1	1	1	5
NONE	OG0010252	1	1	1	0	1	1	5
NONE	OG0010253	1	1	1	0	1	1	5
NONE	OG0010254	1	0	1	1	1	1	5
NONE	OG0010255	1	1	1	1	1	0	5
NONE	OG0010256	1	1	1	0	1	1	5
NONE	OG0010257	1	1	1	0	1	1	5
NONE	OG0010258	1	1	1	1	1	0	5
NONE	OG0010259	1	0	1	1	1	1	5
NONE	OG0010260	1	1	1	0	1	1	5
NONE	OG0010261	1	1	1	0	1	1	5
NONE	OG0010262	1	1	1	1	1	0	5
NONE	OG0010263	1	1	1	0	1	1	5
NONE	OG0010264	1	0	1	1	1	1	5
NONE	OG0010265	1	1	1	0	1	1	5
NONE	OG0010266	1	1	1	1	0	1	5
NONE	OG0010267	1	1	1	0	1	1	5
NONE	OG0010268	1	1	1	0	1	1	5
NONE	OG0010269	1	1	1	0	1	1	5
NONE	OG0010270	1	1	1	0	1	1	5
NONE	OG0010271	1	0	1	1	1	1	5
NONE	OG0010272	1	1	1	0	1	1	5
NONE	OG0010273	1	1	1	0	1	1	5
NONE	OG0010274	1	1	1	0	1	1	5
NONE	OG0010275	1	1	1	0	1	1	5
NONE	OG0010276	1	1	1	0	1	1	5
NONE	OG0010277	1	1	1	0	1	1	5
NONE	OG0010278	1	1	1	0	1	1	5
NONE	OG0010279	1	1	1	0	1	1	5
NONE	OG0010280	1	1	1	0	1	1	5
NONE	OG0010281	1	1	1	0	1	1	5
NONE	OG0010282	1	1	1	0	1	1	5
NONE	OG0010283	1	1	1	1	1	0	5
NONE	OG0010284	1	1	1	0	1	1	5
NONE	OG0010285	1	1	1	0	1	1	5
NONE	OG0010286	1	1	1	0	1	1	5
NONE	OG0010287	1	0	1	1	1	1	5
NONE	OG0010288	1	1	1	1	1	0	5
NONE	OG0010289	1	1	1	1	0	1	5
NONE	OG0010290	1	0	1	1	1	1	5
NONE	OG0010291	1	1	1	1	0	1	5
NONE	OG0010292	1	0	1	1	1	1	5
NONE	OG0010293	1	1	0	1	1	1	5
NONE	OG0010294	1	0	1	1	1	1	5
NONE	OG0010295	1	0	1	1	1	1	5
NONE	OG0010296	1	0	1	1	1	1	5
NONE	OG0010297	1	1	1	0	1	1	5
NONE	OG0010298	1	1	1	1	0	1	5
NONE	OG0010299	1	0	1	1	1	1	5
NONE	OG0010300	1	0	1	1	1	1	5
NONE	OG0010301	1	1	1	1	0	1	5
NONE	OG0010302	1	1	1	1	1	0	5
NONE	OG0010303	1	1	1	1	1	0	5
NONE	OG0010304	1	0	1	1	1	1	5
NONE	OG0010305	1	1	1	1	0	1	5
NONE	OG0010306	1	1	1	1	0	1	5
NONE	OG0010307	1	1	1	1	0	1	5
NONE	OG0010308	1	0	1	1	1	1	5
NONE	OG0010309	1	1	1	1	1	0	5
NONE	OG0010310	1	1	1	1	1	0	5
NONE	OG0010311	1	1	1	1	1	0	5
NONE	OG0010312	1	1	1	1	0	1	5
NONE	OG0010313	1	0	1	1	1	1	5
NONE	OG0010314	1	1	0	2	0	1	5
NONE	OG0010315	1	0	1	1	1	1	5
NONE	OG0010316	1	0	1	1	1	1	5
NONE	OG0010317	1	1	1	1	0	1	5
NONE	OG0010318	1	1	0	1	1	1	5
NONE	OG0010319	1	1	1	1	1	0	5
NONE	OG0010320	1	0	1	1	1	1	5
NONE	OG0010321	1	1	1	1	0	1	5
NONE	OG0010322	1	0	1	1	1	1	5
NONE	OG0010323	1	0	1	1	1	1	5
NONE	OG0010324	1	0	1	1	1	1	5
NONE	OG0010325	1	0	3	0	0	1	5
NONE	OG0010326	1	1	1	1	0	1	5
NONE	OG0010327	1	1	1	1	1	0	5
NONE	OG0010328	1	1	1	1	0	1	5
NONE	OG0010329	1	1	1	1	1	0	5
NONE	OG0010330	1	0	1	1	1	1	5
NONE	OG0010331	1	0	1	1	1	1	5
NONE	OG0010332	1	1	1	1	0	1	5
NONE	OG0010333	1	1	1	1	0	1	5
NONE	OG0010334	2	1	1	1	0	0	5
NONE	OG0010335	1	1	1	0	0	2	5
NONE	OG0010336	1	1	1	1	0	1	5
NONE	OG0010337	1	0	1	2	0	1	5
NONE	OG0010338	1	0	1	1	0	2	5
NONE	OG0010339	1	1	1	2	0	0	5
NONE	OG0010340	1	1	1	1	0	1	5
NONE	OG0010341	1	1	1	1	1	0	5
NONE	OG0010342	1	0	1	1	1	1	5
NONE	OG0010343	1	1	1	1	0	1	5
NONE	OG0010344	1	1	1	1	0	1	5
NONE	OG0010345	1	1	1	1	0	1	5
NONE	OG0010346	1	1	0	1	1	1	5
NONE	OG0010347	2	0	1	1	0	1	5
NONE	OG0010348	1	1	1	1	0	1	5
NONE	OG0010349	1	0	1	1	1	1	5
NONE	OG0010350	1	0	1	1	1	1	5
NONE	OG0010351	1	0	1	1	1	1	5
NONE	OG0010352	1	0	1	1	1	1	5
NONE	OG0010353	1	0	1	1	1	1	5
NONE	OG0010354	1	1	1	1	1	0	5
NONE	OG0010355	1	0	1	1	1	1	5
NONE	OG0010356	1	1	1	1	0	1	5
NONE	OG0010357	1	0	1	2	0	1	5
NONE	OG0010358	1	0	1	2	0	1	5
NONE	OG0010359	1	1	0	1	1	1	5
NONE	OG0010360	1	0	1	1	1	1	5
NONE	OG0010361	1	1	1	1	0	1	5
NONE	OG0010362	1	0	1	1	1	1	5
NONE	OG0010363	1	1	1	1	0	1	5
NONE	OG0010364	1	0	1	1	1	1	5
NONE	OG0010365	1	1	1	1	0	1	5
NONE	OG0010366	1	1	1	1	0	1	5
NONE	OG0010367	1	0	3	1	0	0	5
NONE	OG0010368	1	0	1	1	1	1	5
NONE	OG0010369	1	0	2	1	0	1	5
NONE	OG0010370	1	1	1	1	0	1	5
NONE	OG0010371	1	1	1	1	0	1	5
NONE	OG0010372	1	0	1	1	1	1	5
NONE	OG0010373	1	1	1	1	0	1	5
NONE	OG0010374	1	0	1	2	0	1	5
NONE	OG0010375	2	0	1	1	0	1	5
NONE	OG0010376	1	0	1	2	0	1	5
NONE	OG0010377	1	0	1	1	1	1	5
NONE	OG0010378	1	1	1	1	0	1	5
NONE	OG0010379	1	1	1	1	1	0	5
NONE	OG0010380	1	0	1	1	1	1	5
NONE	OG0010381	1	1	1	1	0	1	5
NONE	OG0010382	1	1	1	1	0	1	5
NONE	OG0010383	1	0	1	1	1	1	5
NONE	OG0010384	1	1	1	1	0	1	5
NONE	OG0010385	1	1	0	1	0	2	5
NONE	OG0010386	2	0	1	1	0	1	5
NONE	OG0010387	1	0	1	1	1	1	5
NONE	OG0010388	1	0	1	1	1	1	5
NONE	OG0010389	1	1	1	1	0	1	5
NONE	OG0010390	1	0	1	1	1	1	5
NONE	OG0010391	1	0	1	1	1	1	5
NONE	OG0010392	1	0	1	1	1	1	5
NONE	OG0010393	1	1	1	1	0	1	5
NONE	OG0010394	2	0	1	1	0	1	5
NONE	OG0010395	1	0	1	1	1	1	5
NONE	OG0010396	1	0	1	1	1	1	5
NONE	OG0010397	1	0	1	1	1	1	5
NONE	OG0010398	1	0	1	1	1	1	5
NONE	OG0010399	1	1	1	1	0	1	5
NONE	OG0010400	1	0	1	1	1	1	5
NONE	OG0010401	1	0	1	1	0	2	5
NONE	OG0010402	1	1	1	1	0	1	5
NONE	OG0010403	1	1	1	1	0	1	5
NONE	OG0010404	1	1	1	1	0	1	5
NONE	OG0010405	1	0	2	1	0	1	5
NONE	OG0010406	1	1	1	1	0	1	5
NONE	OG0010407	1	0	1	1	1	1	5
NONE	OG0010408	3	0	1	1	0	0	5
NONE	OG0010409	1	1	1	1	0	1	5
NONE	OG0010410	1	0	1	1	1	1	5
NONE	OG0010411	1	1	1	1	0	1	5
NONE	OG0010412	1	0	4	0	0	0	5
NONE	OG0010413	1	1	1	1	0	1	5
NONE	OG0010414	1	1	1	1	0	1	5
NONE	OG0010415	1	1	1	1	0	1	5
NONE	OG0010416	1	1	1	0	1	1	5
NONE	OG0010417	1	0	1	1	1	1	5
NONE	OG0010418	1	0	1	1	1	1	5
NONE	OG0010419	1	0	1	1	1	1	5
NONE	OG0010420	1	0	1	1	1	1	5
NONE	OG0010421	1	1	1	1	0	1	5
NONE	OG0010422	1	1	1	0	1	1	5
NONE	OG0010423	1	1	1	0	1	1	5
NONE	OG0010424	1	1	1	0	1	1	5
NONE	OG0010425	1	1	1	0	1	1	5
NONE	OG0010426	1	1	1	0	1	1	5
NONE	OG0010427	1	1	1	0	1	1	5
NONE	OG0010428	1	1	1	0	1	1	5
NONE	OG0010429	1	1	1	0	1	1	5
NONE	OG0010430	1	1	1	0	1	1	5
NONE	OG0010431	1	1	1	1	0	1	5
NONE	OG0010432	1	0	1	1	1	1	5
NONE	OG0010433	1	0	1	1	1	1	5
NONE	OG0010434	1	0	1	1	1	1	5
NONE	OG0010435	1	1	1	1	0	1	5
NONE	OG0010436	1	0	1	1	1	1	5
NONE	OG0010437	1	1	1	1	0	1	5
NONE	OG0010438	1	0	1	1	1	1	5
NONE	OG0010439	1	0	1	1	1	1	5
NONE	OG0010440	1	1	1	1	0	1	5
NONE	OG0010441	1	0	1	1	1	1	5
NONE	OG0010442	1	0	1	1	1	1	5
NONE	OG0010443	1	0	1	1	1	1	5
NONE	OG0010444	1	1	1	1	0	1	5
NONE	OG0010445	2	0	1	1	0	1	5
NONE	OG0010446	1	1	1	1	1	0	5
NONE	OG0010447	1	1	1	1	1	0	5
NONE	OG0010448	1	0	1	1	1	1	5
NONE	OG0010449	1	0	1	1	1	1	5
NONE	OG0010450	1	1	1	1	0	1	5
NONE	OG0010451	1	1	1	1	0	1	5
NONE	OG0010452	1	1	1	1	0	1	5
NONE	OG0010453	1	1	1	1	1	0	5
NONE	OG0010454	1	0	1	1	1	1	5
NONE	OG0010455	1	1	1	1	0	1	5
NONE	OG0010456	1	0	1	1	1	1	5
NONE	OG0010457	1	1	1	1	0	1	5
NONE	OG0010458	1	0	0	2	1	1	5
NONE	OG0010459	1	0	1	1	1	1	5
NONE	OG0010460	1	0	1	1	1	1	5
NONE	OG0010461	1	1	1	0	1	1	5
NONE	OG0010462	1	0	1	1	1	1	5
NONE	OG0010463	1	1	1	1	0	1	5
NONE	OG0010464	1	1	1	0	1	1	5
NONE	OG0010465	1	1	1	1	0	1	5
NONE	OG0010466	1	1	1	1	0	1	5
NONE	OG0010467	1	0	4	0	0	0	5
NONE	OG0010468	2	0	1	1	0	1	5
NONE	OG0010469	1	1	1	0	1	1	5
NONE	OG0010470	1	0	1	1	1	1	5
NONE	OG0010471	1	1	1	1	0	1	5
NONE	OG0010472	1	1	1	1	0	1	5
NONE	OG0010473	1	1	1	1	0	1	5
NONE	OG0010474	1	1	1	1	0	1	5
NONE	OG0010475	1	0	2	0	0	2	5
NONE	OG0010476	1	0	1	1	1	1	5
NONE	OG0010477	2	0	1	1	0	1	5
NONE	OG0010478	1	1	1	1	0	1	5
NONE	OG0010479	1	1	0	2	0	1	5
NONE	OG0010480	1	1	1	1	0	1	5
NONE	OG0010481	1	1	1	1	0	1	5
NONE	OG0010482	1	1	1	0	1	1	5
NONE	OG0010483	1	0	1	1	1	1	5
NONE	OG0010484	1	0	1	1	1	1	5
NONE	OG0010485	1	1	1	1	0	1	5
NONE	OG0010486	1	0	1	1	1	1	5
NONE	OG0010487	1	1	1	1	1	0	5
NONE	OG0010488	1	1	1	1	0	1	5
NONE	OG0010489	1	1	1	1	0	1	5
NONE	OG0010490	1	0	1	1	0	2	5
NONE	OG0010491	1	1	1	1	0	1	5
NONE	OG0010492	1	0	1	1	1	1	5
NONE	OG0010493	1	0	1	1	1	1	5
NONE	OG0010494	1	1	1	1	0	1	5
NONE	OG0010495	1	1	1	1	0	1	5
NONE	OG0010496	2	0	1	2	0	0	5
NONE	OG0010497	1	0	1	1	1	1	5
NONE	OG0010498	1	0	1	1	1	1	5
NONE	OG0010499	1	0	1	1	1	1	5
NONE	OG0010500	1	0	3	0	0	1	5
NONE	OG0010501	1	1	1	0	1	1	5
NONE	OG0010502	1	0	1	1	1	1	5
NONE	OG0010503	1	1	1	1	0	1	5
NONE	OG0010504	1	1	1	0	2	0	5
NONE	OG0010505	2	0	1	1	0	1	5
NONE	OG0010506	1	1	1	1	0	1	5
NONE	OG0010507	2	0	1	1	0	1	5
NONE	OG0010508	1	1	1	1	0	1	5
NONE	OG0010509	1	1	1	1	0	1	5
NONE	OG0010510	1	1	1	1	0	1	5
NONE	OG0010511	1	1	1	1	0	1	5
NONE	OG0010512	2	0	2	1	0	0	5
NONE	OG0010513	1	0	1	1	1	1	5
NONE	OG0010514	2	0	1	1	0	1	5
NONE	OG0010515	1	1	1	1	0	1	5
NONE	OG0010516	1	1	1	1	0	1	5
NONE	OG0010517	1	1	1	1	0	1	5
NONE	OG0010518	1	0	1	1	1	1	5
NONE	OG0010519	1	1	1	1	0	1	5
NONE	OG0010520	1	1	1	1	0	1	5
NONE	OG0010521	1	0	1	1	1	1	5
NONE	OG0010522	1	0	1	1	1	1	5
NONE	OG0010523	1	1	1	1	0	1	5
NONE	OG0010524	1	0	1	1	1	1	5
NONE	OG0010525	1	1	1	1	0	1	5
NONE	OG0010526	1	0	1	2	0	1	5
NONE	OG0010527	1	0	1	1	1	1	5
NONE	OG0010528	1	0	1	1	1	1	5
NONE	OG0010529	1	0	1	2	1	0	5
NONE	OG0010530	1	0	1	1	1	1	5
NONE	OG0010531	1	1	1	1	0	1	5
NONE	OG0010532	1	1	1	1	0	1	5
NONE	OG0010533	1	1	1	1	0	1	5
NONE	OG0010534	1	0	1	1	1	1	5
NONE	OG0010535	1	0	1	1	1	1	5
NONE	OG0010536	1	0	1	1	1	1	5
NONE	OG0010537	1	1	1	2	0	0	5
NONE	OG0010538	1	0	1	1	1	1	5
NONE	OG0010539	1	1	0	1	1	1	5
NONE	OG0010540	1	1	1	1	0	1	5
NONE	OG0010541	1	1	1	1	0	1	5
NONE	OG0010542	1	1	1	1	0	1	5
NONE	OG0010543	1	0	1	1	1	1	5
NONE	OG0010544	1	0	1	1	1	1	5
NONE	OG0010545	1	1	1	1	0	1	5
NONE	OG0010546	1	0	2	1	0	1	5
NONE	OG0010547	1	0	1	1	1	1	5
NONE	OG0010548	1	1	1	1	0	1	5
NONE	OG0010549	1	1	1	1	1	0	5
NONE	OG0010550	1	0	2	1	0	1	5
NONE	OG0010551	1	1	2	1	0	0	5
NONE	OG0010552	1	0	1	1	1	1	5
NONE	OG0010553	1	1	1	1	0	1	5
NONE	OG0010554	1	1	1	1	0	1	5
NONE	OG0010555	1	0	1	1	1	1	5
NONE	OG0010556	1	0	2	0	0	2	5
NONE	OG0010557	1	1	1	1	0	1	5
NONE	OG0010558	1	0	1	1	1	1	5
NONE	OG0010559	1	0	1	1	1	1	5
NONE	OG0010560	1	0	1	1	0	2	5
NONE	OG0010561	1	1	1	1	0	1	5
NONE	OG0010562	1	1	1	1	0	1	5
NONE	OG0010563	1	1	1	1	0	1	5
NONE	OG0010564	1	0	1	1	1	1	5
NONE	OG0010565	1	0	1	1	0	2	5
NONE	OG0010566	1	0	1	1	1	1	5
NONE	OG0010567	1	1	1	1	0	1	5
NONE	OG0010568	1	0	1	2	0	1	5
NONE	OG0010569	1	0	1	1	1	1	5
NONE	OG0010570	1	1	1	0	1	1	5
NONE	OG0010571	1	0	1	1	1	1	5
NONE	OG0010572	1	0	1	1	1	1	5
NONE	OG0010573	1	0	1	1	1	1	5
NONE	OG0010574	1	1	1	1	0	1	5
NONE	OG0010575	1	1	1	1	0	1	5
NONE	OG0010576	1	0	1	2	0	1	5
NONE	OG0010577	1	0	1	1	1	1	5
NONE	OG0010578	1	0	1	1	1	1	5
NONE	OG0010579	1	0	1	1	1	1	5
NONE	OG0010580	1	0	1	1	1	1	5
NONE	OG0010581	1	1	1	1	0	1	5
NONE	OG0010582	1	0	1	1	1	1	5
NONE	OG0010583	1	1	1	1	0	1	5
NONE	OG0010584	1	1	1	1	1	0	5
NONE	OG0010585	1	1	1	1	0	1	5
NONE	OG0010586	1	1	1	1	0	1	5
NONE	OG0010587	1	1	1	0	1	1	5
NONE	OG0010588	1	0	1	1	1	1	5
NONE	OG0010589	1	0	1	1	1	1	5
NONE	OG0010590	1	1	1	1	0	1	5
NONE	OG0010591	1	0	1	1	1	1	5
NONE	OG0010592	1	0	1	1	1	1	5
NONE	OG0010593	1	0	1	1	1	1	5
NONE	OG0010594	1	0	1	1	0	2	5
NONE	OG0010595	1	0	1	1	1	1	5
NONE	OG0010596	1	0	1	1	1	1	5
NONE	OG0010597	1	1	1	1	0	1	5
NONE	OG0010598	1	1	1	0	1	1	5
NONE	OG0010599	1	0	1	1	1	1	5
NONE	OG0010600	1	1	1	1	0	1	5
NONE	OG0010601	1	0	1	1	1	1	5
NONE	OG0010602	1	0	1	1	1	1	5
NONE	OG0010603	1	0	1	1	1	1	5
NONE	OG0010604	1	0	1	1	1	1	5
NONE	OG0010605	1	0	1	1	1	1	5
NONE	OG0010606	1	0	1	1	1	1	5
NONE	OG0010607	1	0	1	1	1	1	5
NONE	OG0010608	1	0	1	1	1	1	5
NONE	OG0010609	1	1	0	1	1	1	5
NONE	OG0010610	1	0	1	1	1	1	5
NONE	OG0010611	0	5	0	0	0	0	5
NONE	OG0010612	0	3	0	0	2	0	5
NONE	OG0010613	0	1	1	1	1	1	5
NONE	OG0010614	0	1	1	1	1	1	5
NONE	OG0010615	0	1	1	1	1	1	5
NONE	OG0010616	0	1	1	1	1	1	5
NONE	OG0010617	0	1	1	1	1	1	5
NONE	OG0010618	0	1	1	1	1	1	5
NONE	OG0010619	0	1	1	1	1	1	5
NONE	OG0010620	0	5	0	0	0	0	5
NONE	OG0010621	0	1	1	1	1	1	5
NONE	OG0010622	0	1	0	1	2	1	5
NONE	OG0010623	0	1	1	1	1	1	5
NONE	OG0010624	0	5	0	0	0	0	5
NONE	OG0010625	0	1	1	2	0	1	5
NONE	OG0010626	0	1	1	1	1	1	5
NONE	OG0010627	0	2	0	0	1	2	5
NONE	OG0010628	0	1	1	1	1	1	5
NONE	OG0010629	0	1	1	2	0	1	5
NONE	OG0010630	0	1	1	2	0	1	5
NONE	OG0010631	0	1	1	1	1	1	5
NONE	OG0010632	0	1	1	1	1	1	5
NONE	OG0010633	0	1	1	1	1	1	5
NONE	OG0010634	0	1	1	1	1	1	5
NONE	OG0010635	0	1	1	1	1	1	5
NONE	OG0010636	0	5	0	0	0	0	5
NONE	OG0010637	0	1	1	1	1	1	5
NONE	OG0010638	0	2	0	2	0	1	5
NONE	OG0010639	0	1	1	1	1	1	5
NONE	OG0010640	0	1	1	1	0	2	5
NONE	OG0010641	0	1	1	1	1	1	5
NONE	OG0010642	0	5	0	0	0	0	5
NONE	OG0010643	0	1	1	1	1	1	5
NONE	OG0010644	0	1	1	1	1	1	5
NONE	OG0010645	0	3	0	0	2	0	5
NONE	OG0010646	0	1	1	1	1	1	5
NONE	OG0010647	0	1	1	1	1	1	5
NONE	OG0010648	0	1	2	1	0	1	5
NONE	OG0010649	0	1	1	1	1	1	5
NONE	OG0010650	0	1	1	1	1	1	5
NONE	OG0010651	0	1	1	1	1	1	5
NONE	OG0010652	0	1	1	1	1	1	5
NONE	OG0010653	0	1	1	1	1	1	5
NONE	OG0010654	0	1	1	1	1	1	5
NONE	OG0010655	0	1	1	2	0	1	5
NONE	OG0010656	0	1	1	1	1	1	5
NONE	OG0010657	0	1	1	1	1	1	5
NONE	OG0010658	0	1	1	1	1	1	5
NONE	OG0010659	0	1	1	1	1	1	5
NONE	OG0010660	0	1	1	1	1	1	5
NONE	OG0010661	0	1	1	1	1	1	5
NONE	OG0010662	0	1	1	1	1	1	5
NONE	OG0010663	0	1	1	1	1	1	5
NONE	OG0010664	0	1	1	1	1	1	5
NONE	OG0010665	0	1	1	1	1	1	5
NONE	OG0010666	0	1	1	1	1	1	5
NONE	OG0010667	0	1	1	1	1	1	5
NONE	OG0010668	0	1	1	1	1	1	5
NONE	OG0010669	0	1	1	1	1	1	5
NONE	OG0010670	0	1	1	1	1	1	5
NONE	OG0010671	0	1	1	1	1	1	5
NONE	OG0010672	0	1	1	1	1	1	5
NONE	OG0010673	0	1	1	1	1	1	5
NONE	OG0010674	0	1	1	1	1	1	5
NONE	OG0010675	0	1	1	1	1	1	5
NONE	OG0010676	0	2	0	1	1	1	5
NONE	OG0010677	0	1	1	1	1	1	5
NONE	OG0010678	0	1	1	1	1	1	5
NONE	OG0010679	0	1	1	1	1	1	5
NONE	OG0010680	0	1	1	0	2	1	5
NONE	OG0010681	0	1	1	2	0	1	5
NONE	OG0010682	0	1	1	1	1	1	5
NONE	OG0010683	0	1	0	1	0	3	5
NONE	OG0010684	0	1	1	1	1	1	5
NONE	OG0010685	0	2	0	1	0	2	5
NONE	OG0010686	0	2	0	2	1	0	5
NONE	OG0010687	0	1	1	1	1	1	5
NONE	OG0010688	0	1	1	1	1	1	5
NONE	OG0010689	0	1	1	1	1	1	5
NONE	OG0010690	0	2	1	1	0	1	5
NONE	OG0010691	0	1	1	1	1	1	5
NONE	OG0010692	0	1	1	1	1	1	5
NONE	OG0010693	0	1	1	1	1	1	5
NONE	OG0010694	0	1	1	1	1	1	5
NONE	OG0010695	0	0	5	0	0	0	5
NONE	OG0010696	0	0	5	0	0	0	5
NONE	OG0010697	0	0	1	1	2	1	5
NONE	OG0010698	0	0	5	0	0	0	5
NONE	OG0010699	0	0	3	0	0	2	5
NONE	OG0010700	0	0	5	0	0	0	5
NONE	OG0010701	0	0	2	1	1	1	5
NONE	OG0010702	0	0	5	0	0	0	5
NONE	OG0010703	0	0	5	0	0	0	5
NONE	OG0010704	0	0	4	0	0	1	5
NONE	OG0010705	0	0	2	0	0	3	5
NONE	OG0010706	0	0	5	0	0	0	5
NONE	OG0010707	0	0	1	1	0	3	5
NONE	OG0010708	0	0	1	2	1	1	5
NONE	OG0010709	0	0	3	1	0	1	5
NONE	OG0010710	0	0	5	0	0	0	5
NONE	OG0010711	0	0	1	1	0	3	5
NONE	OG0010712	0	0	3	0	0	2	5
NONE	OG0010713	0	0	5	0	0	0	5
NONE	OG0010714	0	0	4	0	0	1	5
NONE	OG0010715	0	0	4	0	0	1	5
NONE	OG0010716	0	0	1	2	1	1	5
NONE	OG0010717	0	0	2	1	0	2	5
NONE	OG0010718	0	0	2	0	0	3	5
NONE	OG0010719	0	0	2	1	0	2	5
NONE	OG0010720	0	0	3	0	0	2	5
NONE	OG0010721	0	0	3	2	0	0	5
NONE	OG0010722	0	0	4	0	0	1	5
NONE	OG0010723	0	0	3	0	0	2	5
NONE	OG0010724	0	0	4	0	0	1	5
NONE	OG0010725	0	0	1	1	1	2	5
NONE	OG0010726	0	0	1	0	0	4	5
NONE	OG0010727	0	0	5	0	0	0	5
NONE	OG0010728	0	0	0	5	0	0	5
NONE	OG0010729	0	0	0	5	0	0	5
NONE	OG0010730	0	0	0	5	0	0	5
NONE	OG0010731	0	0	0	5	0	0	5
NONE	OG0010732	0	0	0	5	0	0	5
NONE	OG0010733	0	0	0	5	0	0	5
NONE	OG0010734	0	0	0	5	0	0	5
NONE	OG0010735	0	0	0	5	0	0	5
NONE	OG0010736	0	0	0	3	0	2	5
NONE	OG0010737	0	0	0	5	0	0	5
NONE	OG0010738	0	0	0	5	0	0	5
NONE	OG0010739	0	0	0	5	0	0	5
NONE	OG0010740	0	0	0	5	0	0	5
NONE	OG0010741	0	0	0	5	0	0	5
NONE	OG0010742	0	0	0	5	0	0	5
NONE	OG0010743	0	0	0	5	0	0	5
NONE	OG0010744	0	0	0	5	0	0	5
NONE	OG0010745	0	0	0	1	0	4	5
NONE	OG0010746	0	0	0	5	0	0	5
NONE	OG0010747	0	0	0	3	0	2	5
NONE	OG0010748	0	0	0	5	0	0	5
NONE	OG0010749	0	0	0	1	0	4	5
NONE	OG0010750	0	0	0	5	0	0	5
NONE	OG0010751	0	0	0	5	0	0	5
NONE	OG0010752	0	0	0	5	0	0	5
NONE	OG0010753	0	0	0	1	3	1	5
NONE	OG0010754	0	0	0	5	0	0	5
NONE	OG0010755	0	0	0	2	0	3	5
NONE	OG0010756	0	0	0	5	0	0	5
NONE	OG0010757	0	0	0	4	0	1	5
NONE	OG0010758	0	0	0	4	0	1	5
NONE	OG0010759	0	0	0	5	0	0	5
NONE	OG0010760	0	0	0	1	3	1	5
NONE	OG0010761	0	0	0	5	0	0	5
NONE	OG0010762	0	0	0	0	5	0	5
NONE	OG0010763	0	0	0	0	5	0	5
NONE	OG0010764	0	0	0	0	5	0	5
NONE	OG0010765	0	0	0	0	5	0	5
NONE	OG0010766	0	0	0	0	5	0	5
NONE	OG0010767	0	0	0	0	4	1	5
NONE	OG0010768	0	0	0	0	5	0	5
NONE	OG0010769	0	0	0	0	5	0	5
NONE	OG0010770	0	0	0	0	5	0	5
NONE	OG0010771	0	0	0	0	5	0	5
NONE	OG0010772	0	0	0	0	5	0	5
NONE	OG0010773	0	0	0	0	5	0	5
NONE	OG0010774	0	0	0	0	5	0	5
NONE	OG0010775	0	0	0	0	5	0	5
NONE	OG0010776	0	0	0	0	5	0	5
NONE	OG0010777	0	0	0	0	5	0	5
NONE	OG0010778	0	0	0	0	0	5	5
NONE	OG0010779	0	0	0	0	0	5	5
NONE	OG0010780	0	0	0	0	0	5	5
NONE	OG0010781	0	0	0	0	0	5	5
NONE	OG0010782	0	0	0	0	0	5	5
NONE	OG0010783	0	0	0	0	0	5	5
NONE	OG0010784	0	0	0	0	0	5	5
NONE	OG0010785	0	0	0	0	0	5	5
NONE	OG0010786	0	0	0	0	0	5	5
NONE	OG0010787	0	0	0	0	0	5	5
NONE	OG0010788	0	0	0	0	0	5	5
NONE	OG0010789	0	0	0	0	0	5	5
NONE	OG0010790	0	0	0	0	0	5	5
NONE	OG0010791	0	0	0	0	0	5	5
NONE	OG0010792	1	0	1	0	1	1	4
NONE	OG0010793	1	1	1	0	0	1	4
NONE	OG0010794	1	0	1	2	0	0	4
NONE	OG0010795	1	1	0	1	0	1	4
NONE	OG0010796	1	0	1	1	0	1	4
NONE	OG0010797	3	0	1	0	0	0	4
NONE	OG0010798	1	0	3	0	0	0	4
NONE	OG0010799	4	0	0	0	0	0	4
NONE	OG0010800	1	0	3	0	0	0	4
NONE	OG0010801	1	0	1	0	1	1	4
NONE	OG0010802	1	0	1	1	0	1	4
NONE	OG0010803	1	0	1	1	0	1	4
NONE	OG0010804	1	0	1	1	0	1	4
NONE	OG0010805	1	0	1	1	0	1	4
NONE	OG0010806	1	0	1	1	0	1	4
NONE	OG0010807	1	0	1	2	0	0	4
NONE	OG0010808	1	0	1	1	0	1	4
NONE	OG0010809	1	0	1	1	0	1	4
NONE	OG0010810	1	0	1	1	0	1	4
NONE	OG0010811	1	0	1	1	0	1	4
NONE	OG0010812	1	0	0	2	0	1	4
NONE	OG0010813	1	1	1	1	0	0	4
NONE	OG0010814	1	0	1	1	0	1	4
NONE	OG0010815	1	1	1	1	0	0	4
NONE	OG0010816	1	0	1	1	0	1	4
NONE	OG0010817	1	0	1	1	0	1	4
NONE	OG0010818	1	0	1	1	0	1	4
NONE	OG0010819	1	0	1	1	0	1	4
NONE	OG0010820	1	0	1	1	0	1	4
NONE	OG0010821	1	0	1	1	0	1	4
NONE	OG0010822	4	0	0	0	0	0	4
NONE	OG0010823	2	0	2	0	0	0	4
NONE	OG0010824	2	0	1	0	0	1	4
NONE	OG0010825	1	0	1	0	1	1	4
NONE	OG0010826	1	0	1	1	0	1	4
NONE	OG0010827	1	0	1	1	0	1	4
NONE	OG0010828	1	0	1	1	0	1	4
NONE	OG0010829	1	0	1	1	0	1	4
NONE	OG0010830	1	0	1	1	0	1	4
NONE	OG0010831	2	0	2	0	0	0	4
NONE	OG0010832	1	0	2	1	0	0	4
NONE	OG0010833	3	0	1	0	0	0	4
NONE	OG0010834	1	0	1	1	0	1	4
NONE	OG0010835	1	0	0	1	1	1	4
NONE	OG0010836	1	0	1	0	1	1	4
NONE	OG0010837	1	0	1	0	1	1	4
NONE	OG0010838	2	0	2	0	0	0	4
NONE	OG0010839	2	0	2	0	0	0	4
NONE	OG0010840	1	0	1	1	0	1	4
NONE	OG0010841	1	0	1	1	0	1	4
NONE	OG0010842	1	0	1	1	0	1	4
NONE	OG0010843	1	1	0	1	0	1	4
NONE	OG0010844	1	0	1	1	0	1	4
NONE	OG0010845	4	0	0	0	0	0	4
NONE	OG0010846	3	0	0	0	0	1	4
NONE	OG0010847	1	0	1	1	0	1	4
NONE	OG0010848	1	0	2	0	0	1	4
NONE	OG0010849	1	2	0	1	0	0	4
NONE	OG0010850	2	0	0	0	0	2	4
NONE	OG0010851	1	0	1	1	0	1	4
NONE	OG0010852	1	1	1	1	0	0	4
NONE	OG0010853	1	0	1	1	0	1	4
NONE	OG0010854	1	0	1	1	0	1	4
NONE	OG0010855	1	0	1	1	0	1	4
NONE	OG0010856	2	0	2	0	0	0	4
NONE	OG0010857	1	0	1	1	0	1	4
NONE	OG0010858	1	0	1	1	0	1	4
NONE	OG0010859	1	0	0	0	0	3	4
NONE	OG0010860	1	0	3	0	0	0	4
NONE	OG0010861	1	0	1	1	0	1	4
NONE	OG0010862	1	0	1	1	0	1	4
NONE	OG0010863	1	0	1	1	1	0	4
NONE	OG0010864	1	0	1	1	0	1	4
NONE	OG0010865	1	0	1	1	0	1	4
NONE	OG0010866	1	1	1	0	0	1	4
NONE	OG0010867	1	0	1	1	0	1	4
NONE	OG0010868	1	0	1	1	0	1	4
NONE	OG0010869	1	0	1	1	0	1	4
NONE	OG0010870	1	0	1	1	0	1	4
NONE	OG0010871	1	0	1	1	0	1	4
NONE	OG0010872	1	0	1	1	0	1	4
NONE	OG0010873	1	0	3	0	0	0	4
NONE	OG0010874	1	0	1	1	0	1	4
NONE	OG0010875	1	1	1	0	0	1	4
NONE	OG0010876	4	0	0	0	0	0	4
NONE	OG0010877	1	0	0	3	0	0	4
NONE	OG0010878	2	0	2	0	0	0	4
NONE	OG0010879	1	1	0	1	0	1	4
NONE	OG0010880	1	0	1	1	0	1	4
NONE	OG0010881	1	0	1	1	0	1	4
NONE	OG0010882	1	0	1	0	0	2	4
NONE	OG0010883	1	0	1	1	0	1	4
NONE	OG0010884	1	0	1	1	0	1	4
NONE	OG0010885	1	0	1	1	0	1	4
NONE	OG0010886	4	0	0	0	0	0	4
NONE	OG0010887	1	0	1	2	0	0	4
NONE	OG0010888	2	0	0	0	0	2	4
NONE	OG0010889	3	0	1	0	0	0	4
NONE	OG0010890	3	0	0	0	0	1	4
NONE	OG0010891	1	0	1	1	0	1	4
NONE	OG0010892	1	0	1	1	0	1	4
NONE	OG0010893	1	0	1	0	1	1	4
NONE	OG0010894	2	0	1	1	0	0	4
NONE	OG0010895	1	1	0	1	0	1	4
NONE	OG0010896	1	0	1	2	0	0	4
NONE	OG0010897	1	0	1	1	0	1	4
NONE	OG0010898	1	0	1	1	1	0	4
NONE	OG0010899	1	1	0	1	1	0	4
NONE	OG0010900	1	0	0	3	0	0	4
NONE	OG0010901	1	1	1	0	0	1	4
NONE	OG0010902	1	0	1	1	0	1	4
NONE	OG0010903	2	0	2	0	0	0	4
NONE	OG0010904	4	0	0	0	0	0	4
NONE	OG0010905	1	0	1	1	0	1	4
NONE	OG0010906	4	0	0	0	0	0	4
NONE	OG0010907	1	0	3	0	0	0	4
NONE	OG0010908	3	0	1	0	0	0	4
NONE	OG0010909	1	0	1	1	0	1	4
NONE	OG0010910	1	1	1	0	0	1	4
NONE	OG0010911	1	0	1	1	0	1	4
NONE	OG0010912	1	0	1	1	0	1	4
NONE	OG0010913	4	0	0	0	0	0	4
NONE	OG0010914	4	0	0	0	0	0	4
NONE	OG0010915	1	0	1	1	0	1	4
NONE	OG0010916	1	0	1	1	0	1	4
NONE	OG0010917	1	0	1	1	0	1	4
NONE	OG0010918	1	0	0	2	0	1	4
NONE	OG0010919	1	0	1	1	0	1	4
NONE	OG0010920	2	0	1	1	0	0	4
NONE	OG0010921	1	0	1	1	0	1	4
NONE	OG0010922	3	0	1	0	0	0	4
NONE	OG0010923	1	0	3	0	0	0	4
NONE	OG0010924	1	0	2	0	0	1	4
NONE	OG0010925	1	0	1	1	0	1	4
NONE	OG0010926	1	0	1	0	0	2	4
NONE	OG0010927	1	0	1	1	0	1	4
NONE	OG0010928	2	0	0	0	2	0	4
NONE	OG0010929	1	0	1	1	0	1	4
NONE	OG0010930	1	1	1	1	0	0	4
NONE	OG0010931	1	0	1	1	0	1	4
NONE	OG0010932	3	0	1	0	0	0	4
NONE	OG0010933	3	0	0	0	0	1	4
NONE	OG0010934	3	0	1	0	0	0	4
NONE	OG0010935	1	0	1	1	0	1	4
NONE	OG0010936	1	0	1	1	0	1	4
NONE	OG0010937	2	0	2	0	0	0	4
NONE	OG0010938	2	0	1	0	0	1	4
NONE	OG0010939	1	0	1	1	0	1	4
NONE	OG0010940	1	1	1	1	0	0	4
NONE	OG0010941	3	0	0	0	0	1	4
NONE	OG0010942	4	0	0	0	0	0	4
NONE	OG0010943	1	0	1	1	0	1	4
NONE	OG0010944	4	0	0	0	0	0	4
NONE	OG0010945	1	0	0	3	0	0	4
NONE	OG0010946	1	0	1	1	0	1	4
NONE	OG0010947	1	0	1	1	0	1	4
NONE	OG0010948	1	0	1	1	0	1	4
NONE	OG0010949	1	1	1	1	0	0	4
NONE	OG0010950	1	1	1	1	0	0	4
NONE	OG0010951	1	0	1	1	0	1	4
NONE	OG0010952	1	0	1	1	0	1	4
NONE	OG0010953	1	0	1	1	0	1	4
NONE	OG0010954	1	0	1	1	0	1	4
NONE	OG0010955	1	0	1	1	1	0	4
NONE	OG0010956	1	1	0	1	0	1	4
NONE	OG0010957	1	0	1	1	0	1	4
NONE	OG0010958	1	0	1	1	0	1	4
NONE	OG0010959	1	0	1	0	1	1	4
NONE	OG0010960	1	0	1	1	0	1	4
NONE	OG0010961	1	1	1	1	0	0	4
NONE	OG0010962	1	0	1	1	0	1	4
NONE	OG0010963	4	0	0	0	0	0	4
NONE	OG0010964	3	0	1	0	0	0	4
NONE	OG0010965	1	0	1	1	0	1	4
NONE	OG0010966	1	0	1	1	0	1	4
NONE	OG0010967	1	0	1	1	0	1	4
NONE	OG0010968	1	1	1	0	0	1	4
NONE	OG0010969	1	0	1	0	1	1	4
NONE	OG0010970	1	1	1	1	0	0	4
NONE	OG0010971	1	1	1	0	0	1	4
NONE	OG0010972	1	1	1	0	1	0	4
NONE	OG0010973	1	1	1	0	1	0	4
NONE	OG0010974	1	1	1	0	1	0	4
NONE	OG0010975	1	1	1	0	1	0	4
NONE	OG0010976	1	1	1	0	1	0	4
NONE	OG0010977	1	1	1	0	1	0	4
NONE	OG0010978	1	0	1	0	1	1	4
NONE	OG0010979	1	1	1	0	0	1	4
NONE	OG0010980	1	1	1	0	0	1	4
NONE	OG0010981	4	0	0	0	0	0	4
NONE	OG0010982	1	0	1	0	1	1	4
NONE	OG0010983	4	0	0	0	0	0	4
NONE	OG0010984	3	0	1	0	0	0	4
NONE	OG0010985	2	0	0	0	0	2	4
NONE	OG0010986	1	0	1	0	1	1	4
NONE	OG0010987	1	0	1	0	1	1	4
NONE	OG0010988	1	0	1	0	1	1	4
NONE	OG0010989	1	0	1	0	1	1	4
NONE	OG0010990	1	0	1	0	1	1	4
NONE	OG0010991	1	1	1	1	0	0	4
NONE	OG0010992	1	0	1	1	1	0	4
NONE	OG0010993	1	0	1	1	1	0	4
NONE	OG0010994	1	0	1	1	0	1	4
NONE	OG0010995	1	1	1	0	0	1	4
NONE	OG0010996	1	0	1	1	0	1	4
NONE	OG0010997	1	0	1	1	0	1	4
NONE	OG0010998	1	0	1	1	0	1	4
NONE	OG0010999	1	1	1	0	1	0	4
NONE	OG0011000	1	0	1	1	1	0	4
NONE	OG0011001	1	0	1	1	0	1	4
NONE	OG0011002	1	0	1	1	0	1	4
NONE	OG0011003	1	0	1	1	0	1	4
NONE	OG0011004	1	0	1	1	0	1	4
NONE	OG0011005	1	0	1	1	0	1	4
NONE	OG0011006	1	0	1	1	0	1	4
NONE	OG0011007	1	0	1	1	0	1	4
NONE	OG0011008	1	0	3	0	0	0	4
NONE	OG0011009	3	0	1	0	0	0	4
NONE	OG0011010	1	0	0	2	0	1	4
NONE	OG0011011	1	0	1	1	0	1	4
NONE	OG0011012	2	0	1	0	0	1	4
NONE	OG0011013	1	0	0	1	1	1	4
NONE	OG0011014	1	0	1	1	0	1	4
NONE	OG0011015	1	0	1	1	0	1	4
NONE	OG0011016	2	0	1	1	0	0	4
NONE	OG0011017	1	0	1	1	0	1	4
NONE	OG0011018	2	0	2	0	0	0	4
NONE	OG0011019	4	0	0	0	0	0	4
NONE	OG0011020	2	0	2	0	0	0	4
NONE	OG0011021	2	0	2	0	0	0	4
NONE	OG0011022	3	0	1	0	0	0	4
NONE	OG0011023	1	1	1	1	0	0	4
NONE	OG0011024	1	0	1	1	0	1	4
NONE	OG0011025	1	0	1	1	0	1	4
NONE	OG0011026	1	1	0	0	1	1	4
NONE	OG0011027	1	0	1	1	0	1	4
NONE	OG0011028	1	0	1	1	0	1	4
NONE	OG0011029	2	0	2	0	0	0	4
NONE	OG0011030	1	1	1	1	0	0	4
NONE	OG0011031	1	0	1	1	0	1	4
NONE	OG0011032	1	0	1	1	0	1	4
NONE	OG0011033	4	0	0	0	0	0	4
NONE	OG0011034	1	0	0	0	3	0	4
NONE	OG0011035	1	1	0	1	0	1	4
NONE	OG0011036	3	0	0	0	0	1	4
NONE	OG0011037	2	0	2	0	0	0	4
NONE	OG0011038	1	0	3	0	0	0	4
NONE	OG0011039	1	0	1	1	0	1	4
NONE	OG0011040	2	0	0	1	0	1	4
NONE	OG0011041	1	0	1	1	0	1	4
NONE	OG0011042	1	0	1	1	0	1	4
NONE	OG0011043	1	0	1	1	0	1	4
NONE	OG0011044	1	0	1	1	0	1	4
NONE	OG0011045	1	0	1	1	0	1	4
NONE	OG0011046	1	0	1	1	0	1	4
NONE	OG0011047	1	0	1	1	0	1	4
NONE	OG0011048	1	0	1	1	0	1	4
NONE	OG0011049	1	0	1	1	0	1	4
NONE	OG0011050	1	0	0	2	0	1	4
NONE	OG0011051	1	0	1	1	0	1	4
NONE	OG0011052	1	0	1	1	0	1	4
NONE	OG0011053	2	0	0	0	0	2	4
NONE	OG0011054	1	0	1	1	0	1	4
NONE	OG0011055	2	0	1	1	0	0	4
NONE	OG0011056	1	0	1	1	0	1	4
NONE	OG0011057	1	0	1	0	1	1	4
NONE	OG0011058	1	0	1	1	1	0	4
NONE	OG0011059	1	0	1	1	1	0	4
NONE	OG0011060	1	0	1	1	1	0	4
NONE	OG0011061	1	0	1	1	1	0	4
NONE	OG0011062	1	0	1	1	1	0	4
NONE	OG0011063	1	0	1	1	0	1	4
NONE	OG0011064	1	0	1	0	0	2	4
NONE	OG0011065	1	0	1	1	0	1	4
NONE	OG0011066	1	0	0	0	3	0	4
NONE	OG0011067	1	0	1	1	0	1	4
NONE	OG0011068	1	0	2	1	0	0	4
NONE	OG0011069	1	0	1	0	1	1	4
NONE	OG0011070	1	0	1	2	0	0	4
NONE	OG0011071	1	0	1	1	0	1	4
NONE	OG0011072	1	0	1	1	0	1	4
NONE	OG0011073	1	0	1	1	0	1	4
NONE	OG0011074	1	0	1	0	1	1	4
NONE	OG0011075	1	0	1	1	0	1	4
NONE	OG0011076	1	0	1	1	0	1	4
NONE	OG0011077	2	0	1	1	0	0	4
NONE	OG0011078	1	0	1	1	0	1	4
NONE	OG0011079	1	1	0	1	0	1	4
NONE	OG0011080	4	0	0	0	0	0	4
NONE	OG0011081	1	0	1	1	0	1	4
NONE	OG0011082	1	0	1	1	0	1	4
NONE	OG0011083	1	0	1	1	0	1	4
NONE	OG0011084	2	0	0	0	0	2	4
NONE	OG0011085	4	0	0	0	0	0	4
NONE	OG0011086	1	0	1	0	0	2	4
NONE	OG0011087	1	0	1	1	0	1	4
NONE	OG0011088	1	0	1	1	0	1	4
NONE	OG0011089	1	0	1	1	0	1	4
NONE	OG0011090	1	0	1	1	0	1	4
NONE	OG0011091	3	0	1	0	0	0	4
NONE	OG0011092	1	0	1	1	0	1	4
NONE	OG0011093	1	0	3	0	0	0	4
NONE	OG0011094	1	0	1	1	0	1	4
NONE	OG0011095	1	0	1	1	0	1	4
NONE	OG0011096	1	1	1	0	0	1	4
NONE	OG0011097	1	0	1	1	0	1	4
NONE	OG0011098	1	0	1	1	0	1	4
NONE	OG0011099	1	0	1	1	0	1	4
NONE	OG0011100	4	0	0	0	0	0	4
NONE	OG0011101	1	0	1	1	0	1	4
NONE	OG0011102	1	0	1	1	0	1	4
NONE	OG0011103	1	0	1	1	0	1	4
NONE	OG0011104	1	0	1	1	0	1	4
NONE	OG0011105	1	0	1	1	0	1	4
NONE	OG0011106	1	0	1	1	0	1	4
NONE	OG0011107	1	1	1	0	0	1	4
NONE	OG0011108	1	0	1	1	0	1	4
NONE	OG0011109	1	0	1	1	0	1	4
NONE	OG0011110	1	0	1	1	0	1	4
NONE	OG0011111	1	1	1	1	0	0	4
NONE	OG0011112	1	0	1	1	0	1	4
NONE	OG0011113	2	0	1	0	0	1	4
NONE	OG0011114	4	0	0	0	0	0	4
NONE	OG0011115	1	0	1	1	0	1	4
NONE	OG0011116	1	0	0	1	1	1	4
NONE	OG0011117	1	0	1	1	0	1	4
NONE	OG0011118	1	0	3	0	0	0	4
NONE	OG0011119	1	0	1	1	0	1	4
NONE	OG0011120	1	0	1	1	0	1	4
NONE	OG0011121	1	0	1	1	0	1	4
NONE	OG0011122	1	0	1	1	0	1	4
NONE	OG0011123	1	0	1	1	0	1	4
NONE	OG0011124	1	0	3	0	0	0	4
NONE	OG0011125	1	0	1	1	0	1	4
NONE	OG0011126	1	0	1	1	0	1	4
NONE	OG0011127	1	1	1	1	0	0	4
NONE	OG0011128	1	0	1	1	1	0	4
NONE	OG0011129	1	1	1	0	0	1	4
NONE	OG0011130	1	1	0	1	1	0	4
NONE	OG0011131	1	1	1	1	0	0	4
NONE	OG0011132	1	0	1	1	0	1	4
NONE	OG0011133	1	0	1	1	0	1	4
NONE	OG0011134	1	0	1	1	0	1	4
NONE	OG0011135	1	0	1	1	0	1	4
NONE	OG0011136	2	0	2	0	0	0	4
NONE	OG0011137	1	0	1	1	0	1	4
NONE	OG0011138	2	0	2	0	0	0	4
NONE	OG0011139	2	0	1	1	0	0	4
NONE	OG0011140	1	0	2	1	0	0	4
NONE	OG0011141	1	0	1	1	0	1	4
NONE	OG0011142	1	0	1	1	0	1	4
NONE	OG0011143	1	0	1	1	0	1	4
NONE	OG0011144	1	0	1	1	0	1	4
NONE	OG0011145	1	0	1	1	0	1	4
NONE	OG0011146	4	0	0	0	0	0	4
NONE	OG0011147	2	0	2	0	0	0	4
NONE	OG0011148	4	0	0	0	0	0	4
NONE	OG0011149	1	0	1	1	0	1	4
NONE	OG0011150	1	0	1	1	0	1	4
NONE	OG0011151	1	0	1	1	0	1	4
NONE	OG0011152	1	0	1	1	0	1	4
NONE	OG0011153	2	0	1	0	0	1	4
NONE	OG0011154	1	0	3	0	0	0	4
NONE	OG0011155	1	0	1	1	0	1	4
NONE	OG0011156	1	0	1	2	0	0	4
NONE	OG0011157	1	0	1	1	0	1	4
NONE	OG0011158	3	0	1	0	0	0	4
NONE	OG0011159	1	0	1	2	0	0	4
NONE	OG0011160	1	0	1	1	0	1	4
NONE	OG0011161	1	1	1	1	0	0	4
NONE	OG0011162	1	0	1	2	0	0	4
NONE	OG0011163	3	0	1	0	0	0	4
NONE	OG0011164	2	0	0	1	0	1	4
NONE	OG0011165	1	0	1	1	0	1	4
NONE	OG0011166	1	0	1	1	0	1	4
NONE	OG0011167	1	0	1	1	0	1	4
NONE	OG0011168	1	0	1	1	0	1	4
NONE	OG0011169	1	0	1	1	0	1	4
NONE	OG0011170	2	0	1	1	0	0	4
NONE	OG0011171	4	0	0	0	0	0	4
NONE	OG0011172	1	0	1	1	0	1	4
NONE	OG0011173	1	0	1	1	0	1	4
NONE	OG0011174	1	0	1	1	0	1	4
NONE	OG0011175	1	0	1	1	0	1	4
NONE	OG0011176	1	0	1	1	0	1	4
NONE	OG0011177	1	1	0	1	0	1	4
NONE	OG0011178	1	0	1	1	0	1	4
NONE	OG0011179	2	0	1	1	0	0	4
NONE	OG0011180	2	0	1	0	0	1	4
NONE	OG0011181	1	0	1	1	0	1	4
NONE	OG0011182	1	1	1	0	0	1	4
NONE	OG0011183	1	0	1	1	1	0	4
NONE	OG0011184	3	0	1	0	0	0	4
NONE	OG0011185	1	0	3	0	0	0	4
NONE	OG0011186	2	0	1	0	0	1	4
NONE	OG0011187	2	0	2	0	0	0	4
NONE	OG0011188	1	0	1	1	0	1	4
NONE	OG0011189	1	0	1	1	0	1	4
NONE	OG0011190	1	0	1	1	0	1	4
NONE	OG0011191	1	0	1	1	0	1	4
NONE	OG0011192	1	1	1	0	0	1	4
NONE	OG0011193	1	0	1	1	0	1	4
NONE	OG0011194	2	0	2	0	0	0	4
NONE	OG0011195	1	0	2	1	0	0	4
NONE	OG0011196	1	0	1	1	0	1	4
NONE	OG0011197	1	0	1	1	0	1	4
NONE	OG0011198	2	0	2	0	0	0	4
NONE	OG0011199	1	0	1	1	0	1	4
NONE	OG0011200	1	0	1	1	0	1	4
NONE	OG0011201	1	0	1	1	0	1	4
NONE	OG0011202	1	0	1	0	0	2	4
NONE	OG0011203	3	0	1	0	0	0	4
NONE	OG0011204	1	0	1	1	0	1	4
NONE	OG0011205	2	0	1	0	0	1	4
NONE	OG0011206	1	1	1	0	0	1	4
NONE	OG0011207	1	0	1	1	0	1	4
NONE	OG0011208	1	0	1	1	0	1	4
NONE	OG0011209	3	0	1	0	0	0	4
NONE	OG0011210	1	0	1	1	0	1	4
NONE	OG0011211	1	0	1	1	0	1	4
NONE	OG0011212	1	0	3	0	0	0	4
NONE	OG0011213	2	0	1	1	0	0	4
NONE	OG0011214	1	0	1	1	0	1	4
NONE	OG0011215	2	0	2	0	0	0	4
NONE	OG0011216	1	0	1	1	0	1	4
NONE	OG0011217	1	0	1	1	0	1	4
NONE	OG0011218	1	0	1	1	0	1	4
NONE	OG0011219	1	0	1	1	0	1	4
NONE	OG0011220	1	0	1	1	0	1	4
NONE	OG0011221	1	0	1	1	0	1	4
NONE	OG0011222	1	0	1	1	0	1	4
NONE	OG0011223	1	0	0	1	0	2	4
NONE	OG0011224	1	0	1	1	0	1	4
NONE	OG0011225	1	0	1	1	0	1	4
NONE	OG0011226	2	0	2	0	0	0	4
NONE	OG0011227	1	0	1	1	0	1	4
NONE	OG0011228	1	0	0	1	1	1	4
NONE	OG0011229	1	0	1	1	0	1	4
NONE	OG0011230	1	0	1	1	0	1	4
NONE	OG0011231	1	0	1	1	0	1	4
NONE	OG0011232	1	0	3	0	0	0	4
NONE	OG0011233	1	0	1	1	0	1	4
NONE	OG0011234	2	0	2	0	0	0	4
NONE	OG0011235	2	0	1	0	0	1	4
NONE	OG0011236	1	0	1	2	0	0	4
NONE	OG0011237	1	1	1	0	0	1	4
NONE	OG0011238	2	0	1	1	0	0	4
NONE	OG0011239	1	0	1	1	0	1	4
NONE	OG0011240	1	0	1	1	0	1	4
NONE	OG0011241	1	0	1	2	0	0	4
NONE	OG0011242	3	0	1	0	0	0	4
NONE	OG0011243	4	0	0	0	0	0	4
NONE	OG0011244	1	1	1	1	0	0	4
NONE	OG0011245	1	0	3	0	0	0	4
NONE	OG0011246	1	0	1	1	0	1	4
NONE	OG0011247	3	0	0	0	0	1	4
NONE	OG0011248	1	0	1	1	0	1	4
NONE	OG0011249	1	0	0	3	0	0	4
NONE	OG0011250	1	0	1	1	0	1	4
NONE	OG0011251	4	0	0	0	0	0	4
NONE	OG0011252	1	0	1	1	1	0	4
NONE	OG0011253	4	0	0	0	0	0	4
NONE	OG0011254	1	0	1	1	0	1	4
NONE	OG0011255	1	0	1	1	0	1	4
NONE	OG0011256	2	1	1	0	0	0	4
NONE	OG0011257	4	0	0	0	0	0	4
NONE	OG0011258	1	0	1	1	0	1	4
NONE	OG0011259	1	0	1	1	0	1	4
NONE	OG0011260	1	0	1	1	0	1	4
NONE	OG0011261	1	0	1	1	0	1	4
NONE	OG0011262	1	0	1	1	0	1	4
NONE	OG0011263	1	0	1	1	0	1	4
NONE	OG0011264	1	0	3	0	0	0	4
NONE	OG0011265	1	0	1	1	0	1	4
NONE	OG0011266	1	0	1	1	1	0	4
NONE	OG0011267	1	0	0	1	1	1	4
NONE	OG0011268	1	0	1	1	1	0	4
NONE	OG0011269	1	1	1	1	0	0	4
NONE	OG0011270	1	0	1	1	1	0	4
NONE	OG0011271	2	0	1	1	0	0	4
NONE	OG0011272	1	0	1	1	1	0	4
NONE	OG0011273	2	0	1	1	0	0	4
NONE	OG0011274	1	0	1	1	0	1	4
NONE	OG0011275	1	1	1	0	1	0	4
NONE	OG0011276	3	0	0	0	0	1	4
NONE	OG0011277	1	0	1	0	0	2	4
NONE	OG0011278	1	0	1	1	1	0	4
NONE	OG0011279	1	1	1	0	1	0	4
NONE	OG0011280	1	0	1	1	0	1	4
NONE	OG0011281	1	0	3	0	0	0	4
NONE	OG0011282	1	0	1	1	0	1	4
NONE	OG0011283	1	0	1	1	0	1	4
NONE	OG0011284	2	0	2	0	0	0	4
NONE	OG0011285	1	1	1	0	0	1	4
NONE	OG0011286	1	0	1	1	0	1	4
NONE	OG0011287	1	0	1	1	0	1	4
NONE	OG0011288	1	0	2	0	0	1	4
NONE	OG0011289	2	0	2	0	0	0	4
NONE	OG0011290	1	0	1	0	1	1	4
NONE	OG0011291	1	0	0	1	1	1	4
NONE	OG0011292	1	0	1	1	0	1	4
NONE	OG0011293	2	0	1	0	0	1	4
NONE	OG0011294	2	0	0	1	0	1	4
NONE	OG0011295	4	0	0	0	0	0	4
NONE	OG0011296	1	0	1	1	0	1	4
NONE	OG0011297	1	0	1	1	0	1	4
NONE	OG0011298	2	0	1	1	0	0	4
NONE	OG0011299	1	0	1	0	1	1	4
NONE	OG0011300	2	0	1	1	0	0	4
NONE	OG0011301	1	0	1	2	0	0	4
NONE	OG0011302	1	0	1	1	0	1	4
NONE	OG0011303	1	0	1	1	0	1	4
NONE	OG0011304	1	1	1	1	0	0	4
NONE	OG0011305	1	0	1	1	0	1	4
NONE	OG0011306	1	0	1	0	0	2	4
NONE	OG0011307	1	0	1	1	0	1	4
NONE	OG0011308	1	0	3	0	0	0	4
NONE	OG0011309	1	0	1	1	0	1	4
NONE	OG0011310	3	0	0	1	0	0	4
NONE	OG0011311	1	0	1	1	0	1	4
NONE	OG0011312	1	0	1	1	0	1	4
NONE	OG0011313	1	0	1	1	0	1	4
NONE	OG0011314	1	1	1	1	0	0	4
NONE	OG0011315	4	0	0	0	0	0	4
NONE	OG0011316	1	0	1	1	0	1	4
NONE	OG0011317	1	0	1	1	0	1	4
NONE	OG0011318	1	0	1	1	0	1	4
NONE	OG0011319	1	0	1	1	0	1	4
NONE	OG0011320	1	0	1	0	1	1	4
NONE	OG0011321	1	0	1	1	0	1	4
NONE	OG0011322	1	0	0	0	0	3	4
NONE	OG0011323	1	0	1	1	0	1	4
NONE	OG0011324	1	0	1	1	0	1	4
NONE	OG0011325	1	1	1	0	0	1	4
NONE	OG0011326	1	0	1	1	0	1	4
NONE	OG0011327	3	0	1	0	0	0	4
NONE	OG0011328	1	0	1	1	0	1	4
NONE	OG0011329	1	0	1	1	0	1	4
NONE	OG0011330	1	0	1	0	0	2	4
NONE	OG0011331	1	0	1	1	0	1	4
NONE	OG0011332	1	0	1	1	0	1	4
NONE	OG0011333	1	0	1	1	0	1	4
NONE	OG0011334	1	0	1	0	1	1	4
NONE	OG0011335	1	0	1	1	0	1	4
NONE	OG0011336	1	0	1	2	0	0	4
NONE	OG0011337	1	0	1	2	0	0	4
NONE	OG0011338	1	0	1	1	0	1	4
NONE	OG0011339	1	1	1	0	0	1	4
NONE	OG0011340	1	0	1	1	0	1	4
NONE	OG0011341	1	0	1	1	0	1	4
NONE	OG0011342	1	0	1	1	0	1	4
NONE	OG0011343	1	0	1	1	0	1	4
NONE	OG0011344	1	0	1	1	0	1	4
NONE	OG0011345	1	0	1	1	0	1	4
NONE	OG0011346	1	0	1	0	1	1	4
NONE	OG0011347	1	0	1	1	0	1	4
NONE	OG0011348	1	1	0	1	0	1	4
NONE	OG0011349	1	0	1	1	0	1	4
NONE	OG0011350	2	0	1	1	0	0	4
NONE	OG0011351	1	0	1	1	0	1	4
NONE	OG0011352	1	0	1	1	0	1	4
NONE	OG0011353	1	0	1	1	0	1	4
NONE	OG0011354	1	0	1	1	0	1	4
NONE	OG0011355	1	0	1	1	0	1	4
NONE	OG0011356	2	0	1	1	0	0	4
NONE	OG0011357	1	1	1	0	0	1	4
NONE	OG0011358	2	0	1	0	0	1	4
NONE	OG0011359	1	0	1	1	0	1	4
NONE	OG0011360	1	0	1	0	1	1	4
NONE	OG0011361	1	1	1	0	0	1	4
NONE	OG0011362	1	0	1	1	0	1	4
NONE	OG0011363	1	0	1	1	0	1	4
NONE	OG0011364	1	0	1	1	0	1	4
NONE	OG0011365	1	0	1	1	0	1	4
NONE	OG0011366	1	0	1	1	0	1	4
NONE	OG0011367	1	1	1	1	0	0	4
NONE	OG0011368	1	0	1	1	0	1	4
NONE	OG0011369	1	0	1	1	1	0	4
NONE	OG0011370	1	0	1	2	0	0	4
NONE	OG0011371	1	0	1	1	0	1	4
NONE	OG0011372	1	0	1	1	0	1	4
NONE	OG0011373	1	0	1	1	0	1	4
NONE	OG0011374	1	0	1	1	0	1	4
NONE	OG0011375	1	0	1	1	0	1	4
NONE	OG0011376	1	0	1	0	1	1	4
NONE	OG0011377	1	1	0	1	1	0	4
NONE	OG0011378	1	1	0	0	1	1	4
NONE	OG0011379	2	0	0	2	0	0	4
NONE	OG0011380	2	0	1	0	0	1	4
NONE	OG0011381	1	0	1	1	0	1	4
NONE	OG0011382	1	0	1	0	1	1	4
NONE	OG0011383	1	0	1	1	1	0	4
NONE	OG0011384	1	0	1	1	0	1	4
NONE	OG0011385	1	0	1	1	0	1	4
NONE	OG0011386	1	0	1	1	0	1	4
NONE	OG0011387	1	0	1	1	0	1	4
NONE	OG0011388	1	0	1	1	0	1	4
NONE	OG0011389	1	0	1	1	0	1	4
NONE	OG0011390	1	0	1	1	0	1	4
NONE	OG0011391	1	0	1	1	0	1	4
NONE	OG0011392	1	0	1	0	1	1	4
NONE	OG0011393	1	0	1	1	0	1	4
NONE	OG0011394	1	0	1	1	0	1	4
NONE	OG0011395	1	0	1	1	0	1	4
NONE	OG0011396	1	0	1	1	0	1	4
NONE	OG0011397	1	0	1	1	0	1	4
NONE	OG0011398	1	0	1	1	0	1	4
NONE	OG0011399	1	0	1	1	0	1	4
NONE	OG0011400	1	0	1	1	0	1	4
NONE	OG0011401	1	0	1	1	0	1	4
NONE	OG0011402	1	0	1	1	0	1	4
NONE	OG0011403	1	0	2	0	0	1	4
NONE	OG0011404	1	0	1	1	0	1	4
NONE	OG0011405	4	0	0	0	0	0	4
NONE	OG0011406	1	0	1	1	0	1	4
NONE	OG0011407	1	0	1	1	0	1	4
NONE	OG0011408	2	0	1	1	0	0	4
NONE	OG0011409	1	0	1	1	1	0	4
NONE	OG0011410	1	0	2	1	0	0	4
NONE	OG0011411	1	0	1	1	1	0	4
NONE	OG0011412	1	0	1	1	1	0	4
NONE	OG0011413	1	0	1	1	1	0	4
NONE	OG0011414	3	0	1	0	0	0	4
NONE	OG0011415	1	0	1	2	0	0	4
NONE	OG0011416	2	0	2	0	0	0	4
NONE	OG0011417	1	1	1	1	0	0	4
NONE	OG0011418	1	0	1	1	1	0	4
NONE	OG0011419	1	0	1	1	0	1	4
NONE	OG0011420	1	0	1	1	0	1	4
NONE	OG0011421	1	0	1	1	0	1	4
NONE	OG0011422	1	0	1	1	0	1	4
NONE	OG0011423	1	0	1	1	0	1	4
NONE	OG0011424	1	0	1	1	0	1	4
NONE	OG0011425	1	0	1	1	0	1	4
NONE	OG0011426	1	0	1	1	0	1	4
NONE	OG0011427	1	0	1	1	0	1	4
NONE	OG0011428	4	0	0	0	0	0	4
NONE	OG0011429	1	0	1	1	0	1	4
NONE	OG0011430	1	0	1	1	0	1	4
NONE	OG0011431	1	0	1	1	1	0	4
NONE	OG0011432	1	0	1	1	0	1	4
NONE	OG0011433	1	0	1	1	0	1	4
NONE	OG0011434	1	0	1	1	0	1	4
NONE	OG0011435	1	0	1	1	0	1	4
NONE	OG0011436	1	0	1	1	0	1	4
NONE	OG0011437	1	0	1	1	0	1	4
NONE	OG0011438	1	1	1	0	0	1	4
NONE	OG0011439	1	0	0	0	0	3	4
NONE	OG0011440	1	0	1	1	0	1	4
NONE	OG0011441	1	0	1	1	0	1	4
NONE	OG0011442	1	0	1	0	1	1	4
NONE	OG0011443	1	1	1	0	0	1	4
NONE	OG0011444	1	0	0	1	0	2	4
NONE	OG0011445	1	0	2	0	0	1	4
NONE	OG0011446	1	0	1	0	1	1	4
NONE	OG0011447	1	0	1	1	0	1	4
NONE	OG0011448	1	0	0	1	1	1	4
NONE	OG0011449	1	0	1	1	0	1	4
NONE	OG0011450	1	0	1	1	0	1	4
NONE	OG0011451	1	0	1	1	0	1	4
NONE	OG0011452	1	0	1	1	0	1	4
NONE	OG0011453	2	0	2	0	0	0	4
NONE	OG0011454	1	0	1	2	0	0	4
NONE	OG0011455	1	0	0	3	0	0	4
NONE	OG0011456	1	1	1	1	0	0	4
NONE	OG0011457	1	0	1	1	0	1	4
NONE	OG0011458	1	0	1	1	0	1	4
NONE	OG0011459	1	0	1	1	0	1	4
NONE	OG0011460	1	0	1	2	0	0	4
NONE	OG0011461	1	0	3	0	0	0	4
NONE	OG0011462	1	0	1	1	0	1	4
NONE	OG0011463	1	0	1	1	0	1	4
NONE	OG0011464	1	0	3	0	0	0	4
NONE	OG0011465	1	0	2	1	0	0	4
NONE	OG0011466	1	0	1	1	0	1	4
NONE	OG0011467	1	0	1	1	0	1	4
NONE	OG0011468	1	0	1	1	0	1	4
NONE	OG0011469	1	0	1	1	0	1	4
NONE	OG0011470	1	0	1	1	0	1	4
NONE	OG0011471	1	0	1	1	0	1	4
NONE	OG0011472	1	0	1	1	0	1	4
NONE	OG0011473	1	0	0	3	0	0	4
NONE	OG0011474	1	1	1	1	0	0	4
NONE	OG0011475	1	0	1	1	0	1	4
NONE	OG0011476	1	0	1	1	0	1	4
NONE	OG0011477	1	0	1	1	0	1	4
NONE	OG0011478	1	0	1	2	0	0	4
NONE	OG0011479	1	0	1	1	0	1	4
NONE	OG0011480	1	0	1	2	0	0	4
NONE	OG0011481	1	0	1	1	0	1	4
NONE	OG0011482	3	0	1	0	0	0	4
NONE	OG0011483	1	0	1	1	0	1	4
NONE	OG0011484	1	0	1	1	0	1	4
NONE	OG0011485	1	0	1	1	0	1	4
NONE	OG0011486	1	0	0	2	0	1	4
NONE	OG0011487	1	0	1	1	0	1	4
NONE	OG0011488	1	0	1	1	0	1	4
NONE	OG0011489	1	0	1	1	0	1	4
NONE	OG0011490	1	1	1	0	0	1	4
NONE	OG0011491	1	0	1	1	0	1	4
NONE	OG0011492	2	0	1	0	0	1	4
NONE	OG0011493	2	0	1	1	0	0	4
NONE	OG0011494	4	0	0	0	0	0	4
NONE	OG0011495	1	1	1	0	0	1	4
NONE	OG0011496	1	1	1	0	0	1	4
NONE	OG0011497	1	1	1	0	0	1	4
NONE	OG0011498	1	1	0	1	1	0	4
NONE	OG0011499	1	0	1	1	0	1	4
NONE	OG0011500	1	0	1	1	0	1	4
NONE	OG0011501	2	0	2	0	0	0	4
NONE	OG0011502	1	0	1	0	0	2	4
NONE	OG0011503	1	0	1	1	1	0	4
NONE	OG0011504	1	0	1	1	0	1	4
NONE	OG0011505	4	0	0	0	0	0	4
NONE	OG0011506	1	0	3	0	0	0	4
NONE	OG0011507	3	0	1	0	0	0	4
NONE	OG0011508	1	0	1	1	0	1	4
NONE	OG0011509	1	0	1	1	0	1	4
NONE	OG0011510	1	0	1	1	0	1	4
NONE	OG0011511	1	1	0	1	0	1	4
NONE	OG0011512	1	0	1	1	0	1	4
NONE	OG0011513	1	0	1	1	0	1	4
NONE	OG0011514	1	0	1	1	0	1	4
NONE	OG0011515	1	0	0	0	0	3	4
NONE	OG0011516	1	0	1	1	0	1	4
NONE	OG0011517	1	0	1	1	0	1	4
NONE	OG0011518	4	0	0	0	0	0	4
NONE	OG0011519	2	0	1	0	0	1	4
NONE	OG0011520	1	0	1	1	0	1	4
NONE	OG0011521	1	1	0	1	0	1	4
NONE	OG0011522	1	0	1	1	0	1	4
NONE	OG0011523	1	0	1	1	0	1	4
NONE	OG0011524	1	0	1	1	0	1	4
NONE	OG0011525	1	0	1	1	0	1	4
NONE	OG0011526	1	0	1	1	0	1	4
NONE	OG0011527	1	0	1	1	0	1	4
NONE	OG0011528	1	0	1	1	0	1	4
NONE	OG0011529	1	0	1	1	0	1	4
NONE	OG0011530	1	0	1	1	0	1	4
NONE	OG0011531	1	0	1	1	0	1	4
NONE	OG0011532	1	0	2	1	0	0	4
NONE	OG0011533	1	0	1	1	0	1	4
NONE	OG0011534	1	0	1	1	0	1	4
NONE	OG0011535	1	0	1	0	0	2	4
NONE	OG0011536	1	1	1	1	0	0	4
NONE	OG0011537	1	0	1	1	0	1	4
NONE	OG0011538	1	1	0	1	0	1	4
NONE	OG0011539	1	0	1	1	0	1	4
NONE	OG0011540	1	0	1	1	0	1	4
NONE	OG0011541	1	0	1	1	0	1	4
NONE	OG0011542	1	0	1	1	0	1	4
NONE	OG0011543	1	0	1	2	0	0	4
NONE	OG0011544	1	1	1	1	0	0	4
NONE	OG0011545	1	0	2	0	0	1	4
NONE	OG0011546	1	0	1	1	0	1	4
NONE	OG0011547	1	0	1	1	0	1	4
NONE	OG0011548	1	0	1	1	0	1	4
NONE	OG0011549	1	0	1	1	0	1	4
NONE	OG0011550	1	0	2	0	0	1	4
NONE	OG0011551	1	0	1	1	0	1	4
NONE	OG0011552	1	0	1	1	0	1	4
NONE	OG0011553	1	0	1	1	1	0	4
NONE	OG0011554	1	0	1	1	0	1	4
NONE	OG0011555	2	0	1	1	0	0	4
NONE	OG0011556	1	0	1	1	0	1	4
NONE	OG0011557	1	0	1	1	0	1	4
NONE	OG0011558	2	0	1	0	0	1	4
NONE	OG0011559	1	1	0	0	1	1	4
NONE	OG0011560	1	0	1	2	0	0	4
NONE	OG0011561	1	0	1	1	0	1	4
NONE	OG0011562	1	0	1	1	0	1	4
NONE	OG0011563	1	0	1	1	0	1	4
NONE	OG0011564	1	0	1	1	1	0	4
NONE	OG0011565	1	0	1	1	0	1	4
NONE	OG0011566	1	0	1	1	1	0	4
NONE	OG0011567	1	0	1	1	1	0	4
NONE	OG0011568	1	0	1	1	0	1	4
NONE	OG0011569	1	0	1	1	0	1	4
NONE	OG0011570	1	1	1	0	0	1	4
NONE	OG0011571	1	0	1	0	1	1	4
NONE	OG0011572	1	0	1	0	1	1	4
NONE	OG0011573	1	0	1	0	1	1	4
NONE	OG0011574	1	1	1	0	1	0	4
NONE	OG0011575	1	0	1	0	1	1	4
NONE	OG0011576	1	0	1	0	1	1	4
NONE	OG0011577	1	0	1	0	1	1	4
NONE	OG0011578	1	1	0	0	1	1	4
NONE	OG0011579	1	1	1	0	1	0	4
NONE	OG0011580	1	0	1	0	1	1	4
NONE	OG0011581	1	0	1	0	1	1	4
NONE	OG0011582	3	0	1	0	0	0	4
NONE	OG0011583	1	0	1	0	1	1	4
NONE	OG0011584	1	0	1	0	1	1	4
NONE	OG0011585	1	0	3	0	0	0	4
NONE	OG0011586	2	0	2	0	0	0	4
NONE	OG0011587	1	0	3	0	0	0	4
NONE	OG0011588	1	0	1	0	1	1	4
NONE	OG0011589	1	0	1	1	0	1	4
NONE	OG0011590	1	1	1	0	0	1	4
NONE	OG0011591	1	0	0	1	0	2	4
NONE	OG0011592	1	0	2	0	0	1	4
NONE	OG0011593	1	1	1	0	1	0	4
NONE	OG0011594	1	1	1	0	1	0	4
NONE	OG0011595	1	0	1	0	1	1	4
NONE	OG0011596	1	1	1	0	1	0	4
NONE	OG0011597	1	1	1	0	1	0	4
NONE	OG0011598	1	0	1	0	1	1	4
NONE	OG0011599	1	1	1	0	0	1	4
NONE	OG0011600	1	1	1	0	0	1	4
NONE	OG0011601	1	1	1	0	1	0	4
NONE	OG0011602	1	0	1	1	1	0	4
NONE	OG0011603	1	1	1	0	1	0	4
NONE	OG0011604	1	0	1	1	0	1	4
NONE	OG0011605	1	1	1	1	0	0	4
NONE	OG0011606	1	0	1	1	0	1	4
NONE	OG0011607	1	1	0	1	0	1	4
NONE	OG0011608	2	0	1	1	0	0	4
NONE	OG0011609	1	0	1	1	0	1	4
NONE	OG0011610	1	0	1	1	0	1	4
NONE	OG0011611	1	1	1	0	0	1	4
NONE	OG0011612	1	1	1	0	1	0	4
NONE	OG0011613	1	0	1	1	0	1	4
NONE	OG0011614	2	0	0	1	1	0	4
NONE	OG0011615	1	0	1	1	0	1	4
NONE	OG0011616	1	0	1	1	1	0	4
NONE	OG0011617	1	0	2	0	1	0	4
NONE	OG0011618	1	0	1	2	0	0	4
NONE	OG0011619	1	0	3	0	0	0	4
NONE	OG0011620	1	0	1	1	0	1	4
NONE	OG0011621	1	0	1	1	0	1	4
NONE	OG0011622	1	0	2	1	0	0	4
NONE	OG0011623	1	0	1	1	0	1	4
NONE	OG0011624	1	1	1	0	1	0	4
NONE	OG0011625	1	1	1	0	0	1	4
NONE	OG0011626	1	0	1	1	0	1	4
NONE	OG0011627	1	0	1	1	0	1	4
NONE	OG0011628	1	0	1	1	0	1	4
NONE	OG0011629	1	0	1	2	0	0	4
NONE	OG0011630	1	0	1	1	0	1	4
NONE	OG0011631	1	1	1	0	0	1	4
NONE	OG0011632	1	0	1	1	0	1	4
NONE	OG0011633	1	0	1	1	0	1	4
NONE	OG0011634	1	0	1	1	0	1	4
NONE	OG0011635	1	0	1	1	0	1	4
NONE	OG0011636	1	0	1	1	0	1	4
NONE	OG0011637	1	0	1	1	0	1	4
NONE	OG0011638	1	0	1	1	0	1	4
NONE	OG0011639	1	0	1	1	0	1	4
NONE	OG0011640	1	1	1	0	0	1	4
NONE	OG0011641	1	0	1	1	0	1	4
NONE	OG0011642	1	0	1	1	0	1	4
NONE	OG0011643	1	0	0	1	1	1	4
NONE	OG0011644	1	0	1	1	0	1	4
NONE	OG0011645	1	0	1	1	0	1	4
NONE	OG0011646	1	0	1	1	0	1	4
NONE	OG0011647	1	0	1	1	0	1	4
NONE	OG0011648	1	0	0	1	1	1	4
NONE	OG0011649	1	0	1	1	0	1	4
NONE	OG0011650	2	0	0	1	0	1	4
NONE	OG0011651	1	0	1	1	0	1	4
NONE	OG0011652	1	0	1	1	0	1	4
NONE	OG0011653	1	0	1	1	0	1	4
NONE	OG0011654	1	0	1	1	0	1	4
NONE	OG0011655	1	0	1	1	0	1	4
NONE	OG0011656	1	0	1	1	0	1	4
NONE	OG0011657	1	0	1	1	0	1	4
NONE	OG0011658	1	0	0	0	0	3	4
NONE	OG0011659	1	0	1	1	0	1	4
NONE	OG0011660	1	0	1	1	0	1	4
NONE	OG0011661	1	0	1	1	0	1	4
NONE	OG0011662	1	0	1	1	0	1	4
NONE	OG0011663	1	0	1	1	0	1	4
NONE	OG0011664	1	0	1	1	0	1	4
NONE	OG0011665	1	0	1	1	0	1	4
NONE	OG0011666	1	0	1	1	0	1	4
NONE	OG0011667	1	0	1	1	0	1	4
NONE	OG0011668	1	0	1	1	0	1	4
NONE	OG0011669	1	0	1	1	0	1	4
NONE	OG0011670	1	0	1	1	0	1	4
NONE	OG0011671	1	0	1	1	0	1	4
NONE	OG0011672	1	0	1	1	0	1	4
NONE	OG0011673	1	0	1	1	0	1	4
NONE	OG0011674	1	0	3	0	0	0	4
NONE	OG0011675	1	0	1	0	1	1	4
NONE	OG0011676	1	1	1	0	0	1	4
NONE	OG0011677	1	1	1	0	0	1	4
NONE	OG0011678	1	0	1	1	0	1	4
NONE	OG0011679	1	0	1	1	0	1	4
NONE	OG0011680	1	1	0	1	1	0	4
NONE	OG0011681	1	0	1	1	0	1	4
NONE	OG0011682	1	0	1	1	0	1	4
NONE	OG0011683	1	0	1	1	0	1	4
NONE	OG0011684	1	0	1	1	0	1	4
NONE	OG0011685	1	1	1	0	0	1	4
NONE	OG0011686	1	0	1	0	2	0	4
NONE	OG0011687	1	0	1	1	0	1	4
NONE	OG0011688	1	0	1	1	0	1	4
NONE	OG0011689	1	1	0	1	0	1	4
NONE	OG0011690	1	0	1	1	0	1	4
NONE	OG0011691	1	0	1	2	0	0	4
NONE	OG0011692	2	0	1	0	0	1	4
NONE	OG0011693	1	0	1	1	0	1	4
NONE	OG0011694	1	1	1	1	0	0	4
NONE	OG0011695	1	0	1	1	0	1	4
NONE	OG0011696	1	1	1	0	0	1	4
NONE	OG0011697	1	0	1	1	0	1	4
NONE	OG0011698	1	1	1	1	0	0	4
NONE	OG0011699	1	0	1	1	0	1	4
NONE	OG0011700	4	0	0	0	0	0	4
NONE	OG0011701	1	0	1	1	0	1	4
NONE	OG0011702	1	0	1	1	0	1	4
NONE	OG0011703	1	0	1	1	0	1	4
NONE	OG0011704	1	0	1	1	0	1	4
NONE	OG0011705	1	0	1	0	1	1	4
NONE	OG0011706	1	0	1	1	0	1	4
NONE	OG0011707	1	0	1	1	0	1	4
NONE	OG0011708	1	0	1	1	0	1	4
NONE	OG0011709	1	0	1	1	0	1	4
NONE	OG0011710	1	1	1	1	0	0	4
NONE	OG0011711	1	0	1	1	0	1	4
NONE	OG0011712	1	0	1	1	0	1	4
NONE	OG0011713	3	0	1	0	0	0	4
NONE	OG0011714	1	0	1	1	0	1	4
NONE	OG0011715	1	0	1	1	0	1	4
NONE	OG0011716	1	0	1	2	0	0	4
NONE	OG0011717	1	0	1	1	0	1	4
NONE	OG0011718	1	0	1	1	0	1	4
NONE	OG0011719	1	0	1	1	0	1	4
NONE	OG0011720	1	0	1	1	0	1	4
NONE	OG0011721	1	1	0	1	0	1	4
NONE	OG0011722	1	0	1	1	0	1	4
NONE	OG0011723	1	0	1	1	0	1	4
NONE	OG0011724	1	1	0	0	2	0	4
NONE	OG0011725	1	0	1	1	0	1	4
NONE	OG0011726	1	0	1	1	0	1	4
NONE	OG0011727	1	0	1	1	0	1	4
NONE	OG0011728	1	0	1	1	0	1	4
NONE	OG0011729	1	0	1	1	0	1	4
NONE	OG0011730	1	0	1	1	0	1	4
NONE	OG0011731	1	0	1	1	0	1	4
NONE	OG0011732	2	0	2	0	0	0	4
NONE	OG0011733	1	0	3	0	0	0	4
NONE	OG0011734	2	0	2	0	0	0	4
NONE	OG0011735	1	0	1	2	0	0	4
NONE	OG0011736	1	0	1	1	0	1	4
NONE	OG0011737	1	0	1	1	0	1	4
NONE	OG0011738	1	0	1	0	2	0	4
NONE	OG0011739	1	0	1	0	1	1	4
NONE	OG0011740	1	0	1	1	0	1	4
NONE	OG0011741	1	0	1	1	0	1	4
NONE	OG0011742	3	0	1	0	0	0	4
NONE	OG0011743	1	0	1	1	0	1	4
NONE	OG0011744	1	0	1	1	0	1	4
NONE	OG0011745	1	1	1	1	0	0	4
NONE	OG0011746	2	0	1	1	0	0	4
NONE	OG0011747	1	1	1	1	0	0	4
NONE	OG0011748	1	0	1	1	0	1	4
NONE	OG0011749	1	0	1	1	0	1	4
NONE	OG0011750	1	0	1	1	0	1	4
NONE	OG0011751	1	1	0	0	1	1	4
NONE	OG0011752	1	0	1	1	0	1	4
NONE	OG0011753	1	0	0	0	0	3	4
NONE	OG0011754	1	0	1	1	0	1	4
NONE	OG0011755	1	0	3	0	0	0	4
NONE	OG0011756	1	0	1	1	0	1	4
NONE	OG0011757	1	0	1	1	0	1	4
NONE	OG0011758	1	0	1	1	0	1	4
NONE	OG0011759	1	0	1	1	0	1	4
NONE	OG0011760	1	0	1	1	0	1	4
NONE	OG0011761	1	0	1	1	0	1	4
NONE	OG0011762	0	1	1	1	0	1	4
NONE	OG0011763	0	1	1	0	1	1	4
NONE	OG0011764	0	1	1	0	1	1	4
NONE	OG0011765	0	1	1	1	1	0	4
NONE	OG0011766	0	1	1	0	1	1	4
NONE	OG0011767	0	1	0	1	1	1	4
NONE	OG0011768	0	1	1	1	0	1	4
NONE	OG0011769	0	4	0	0	0	0	4
NONE	OG0011770	0	4	0	0	0	0	4
NONE	OG0011771	0	1	1	1	0	1	4
NONE	OG0011772	0	1	1	1	0	1	4
NONE	OG0011773	0	1	1	0	1	1	4
NONE	OG0011774	0	1	1	0	1	1	4
NONE	OG0011775	0	1	0	2	0	1	4
NONE	OG0011776	0	1	1	1	0	1	4
NONE	OG0011777	0	1	1	0	2	0	4
NONE	OG0011778	0	1	2	1	0	0	4
NONE	OG0011779	0	1	1	0	1	1	4
NONE	OG0011780	0	1	1	1	0	1	4
NONE	OG0011781	0	1	0	1	1	1	4
NONE	OG0011782	0	1	1	0	1	1	4
NONE	OG0011783	0	1	1	0	1	1	4
NONE	OG0011784	0	1	1	1	0	1	4
NONE	OG0011785	0	1	1	1	0	1	4
NONE	OG0011786	0	1	0	2	0	1	4
NONE	OG0011787	0	1	0	3	0	0	4
NONE	OG0011788	0	1	0	1	1	1	4
NONE	OG0011789	0	1	0	1	1	1	4
NONE	OG0011790	0	1	1	0	1	1	4
NONE	OG0011791	0	1	1	1	0	1	4
NONE	OG0011792	0	2	2	0	0	0	4
NONE	OG0011793	0	1	0	2	0	1	4
NONE	OG0011794	0	1	1	1	0	1	4
NONE	OG0011795	0	1	1	1	1	0	4
NONE	OG0011796	0	1	1	1	0	1	4
NONE	OG0011797	0	1	1	1	0	1	4
NONE	OG0011798	0	1	0	2	0	1	4
NONE	OG0011799	0	1	1	1	0	1	4
NONE	OG0011800	0	1	1	1	1	0	4
NONE	OG0011801	0	1	1	1	1	0	4
NONE	OG0011802	0	1	1	1	1	0	4
NONE	OG0011803	0	1	1	1	0	1	4
NONE	OG0011804	0	1	0	1	1	1	4
NONE	OG0011805	0	1	0	1	1	1	4
NONE	OG0011806	0	1	1	1	0	1	4
NONE	OG0011807	0	1	1	1	0	1	4
NONE	OG0011808	0	1	0	1	1	1	4
NONE	OG0011809	0	1	1	1	0	1	4
NONE	OG0011810	0	0	2	2	0	0	4
NONE	OG0011811	0	0	4	0	0	0	4
NONE	OG0011812	0	0	4	0	0	0	4
NONE	OG0011813	0	0	4	0	0	0	4
NONE	OG0011814	0	0	4	0	0	0	4
NONE	OG0011815	0	0	2	0	1	1	4
NONE	OG0011816	0	0	4	0	0	0	4
NONE	OG0011817	0	0	3	0	0	1	4
NONE	OG0011818	0	0	1	1	1	1	4
NONE	OG0011819	0	0	4	0	0	0	4
NONE	OG0011820	0	0	1	1	1	1	4
NONE	OG0011821	0	0	4	0	0	0	4
NONE	OG0011822	0	0	4	0	0	0	4
NONE	OG0011823	0	0	4	0	0	0	4
NONE	OG0011824	0	0	4	0	0	0	4
NONE	OG0011825	0	0	4	0	0	0	4
NONE	OG0011826	0	0	4	0	0	0	4
NONE	OG0011827	0	0	4	0	0	0	4
NONE	OG0011828	0	0	3	0	0	1	4
NONE	OG0011829	0	0	1	1	1	1	4
NONE	OG0011830	0	0	4	0	0	0	4
NONE	OG0011831	0	0	4	0	0	0	4
NONE	OG0011832	0	0	4	0	0	0	4
NONE	OG0011833	0	0	1	1	1	1	4
NONE	OG0011834	0	0	1	1	1	1	4
NONE	OG0011835	0	0	2	0	0	2	4
NONE	OG0011836	0	0	2	0	1	1	4
NONE	OG0011837	0	0	1	2	0	1	4
NONE	OG0011838	0	0	4	0	0	0	4
NONE	OG0011839	0	0	4	0	0	0	4
NONE	OG0011840	0	0	1	2	0	1	4
NONE	OG0011841	0	0	4	0	0	0	4
NONE	OG0011842	0	0	1	2	0	1	4
NONE	OG0011843	0	0	4	0	0	0	4
NONE	OG0011844	0	0	3	0	0	1	4
NONE	OG0011845	0	0	1	1	1	1	4
NONE	OG0011846	0	0	4	0	0	0	4
NONE	OG0011847	0	0	4	0	0	0	4
NONE	OG0011848	0	0	1	1	1	1	4
NONE	OG0011849	0	0	1	1	1	1	4
NONE	OG0011850	0	0	1	0	0	3	4
NONE	OG0011851	0	0	1	1	0	2	4
NONE	OG0011852	0	0	3	0	0	1	4
NONE	OG0011853	0	0	4	0	0	0	4
NONE	OG0011854	0	0	4	0	0	0	4
NONE	OG0011855	0	0	4	0	0	0	4
NONE	OG0011856	0	0	1	2	0	1	4
NONE	OG0011857	0	0	4	0	0	0	4
NONE	OG0011858	0	0	1	0	0	3	4
NONE	OG0011859	0	0	2	0	0	2	4
NONE	OG0011860	0	0	4	0	0	0	4
NONE	OG0011861	0	0	4	0	0	0	4
NONE	OG0011862	0	0	2	2	0	0	4
NONE	OG0011863	0	0	1	0	0	3	4
NONE	OG0011864	0	0	4	0	0	0	4
NONE	OG0011865	0	0	4	0	0	0	4
NONE	OG0011866	0	0	4	0	0	0	4
NONE	OG0011867	0	0	2	1	0	1	4
NONE	OG0011868	0	0	4	0	0	0	4
NONE	OG0011869	0	0	1	1	1	1	4
NONE	OG0011870	0	0	1	1	1	1	4
NONE	OG0011871	0	0	4	0	0	0	4
NONE	OG0011872	0	0	1	0	0	3	4
NONE	OG0011873	0	0	1	1	1	1	4
NONE	OG0011874	0	0	1	3	0	0	4
NONE	OG0011875	0	0	4	0	0	0	4
NONE	OG0011876	0	0	4	0	0	0	4
NONE	OG0011877	0	0	1	1	1	1	4
NONE	OG0011878	0	0	3	1	0	0	4
NONE	OG0011879	0	0	2	1	0	1	4
NONE	OG0011880	0	0	1	1	1	1	4
NONE	OG0011881	0	0	1	1	1	1	4
NONE	OG0011882	0	0	2	1	0	1	4
NONE	OG0011883	0	0	2	1	0	1	4
NONE	OG0011884	0	0	1	1	1	1	4
NONE	OG0011885	0	0	2	0	2	0	4
NONE	OG0011886	0	0	4	0	0	0	4
NONE	OG0011887	0	0	1	1	1	1	4
NONE	OG0011888	0	0	4	0	0	0	4
NONE	OG0011889	0	0	2	0	0	2	4
NONE	OG0011890	0	0	1	1	1	1	4
NONE	OG0011891	0	0	4	0	0	0	4
NONE	OG0011892	0	0	1	0	0	3	4
NONE	OG0011893	0	0	1	2	0	1	4
NONE	OG0011894	0	0	0	4	0	0	4
NONE	OG0011895	0	0	0	4	0	0	4
NONE	OG0011896	0	0	0	4	0	0	4
NONE	OG0011897	0	0	0	4	0	0	4
NONE	OG0011898	0	0	0	4	0	0	4
NONE	OG0011899	0	0	0	4	0	0	4
NONE	OG0011900	0	0	0	4	0	0	4
NONE	OG0011901	0	0	0	3	0	1	4
NONE	OG0011902	0	0	0	3	1	0	4
NONE	OG0011903	0	0	0	4	0	0	4
NONE	OG0011904	0	0	0	4	0	0	4
NONE	OG0011905	0	0	0	4	0	0	4
NONE	OG0011906	0	0	0	4	0	0	4
NONE	OG0011907	0	0	0	4	0	0	4
NONE	OG0011908	0	0	0	4	0	0	4
NONE	OG0011909	0	0	0	4	0	0	4
NONE	OG0011910	0	0	0	4	0	0	4
NONE	OG0011911	0	0	0	4	0	0	4
NONE	OG0011912	0	0	0	4	0	0	4
NONE	OG0011913	0	0	0	4	0	0	4
NONE	OG0011914	0	0	0	3	1	0	4
NONE	OG0011915	0	0	0	4	0	0	4
NONE	OG0011916	0	0	0	3	1	0	4
NONE	OG0011917	0	0	0	4	0	0	4
NONE	OG0011918	0	0	0	4	0	0	4
NONE	OG0011919	0	0	0	1	0	3	4
NONE	OG0011920	0	0	0	3	1	0	4
NONE	OG0011921	0	0	0	4	0	0	4
NONE	OG0011922	0	0	0	4	0	0	4
NONE	OG0011923	0	0	0	4	0	0	4
NONE	OG0011924	0	0	0	4	0	0	4
NONE	OG0011925	0	0	0	3	0	1	4
NONE	OG0011926	0	0	0	4	0	0	4
NONE	OG0011927	0	0	0	4	0	0	4
NONE	OG0011928	0	0	0	4	0	0	4
NONE	OG0011929	0	0	0	4	0	0	4
NONE	OG0011930	0	0	0	4	0	0	4
NONE	OG0011931	0	0	0	4	0	0	4
NONE	OG0011932	0	0	0	0	4	0	4
NONE	OG0011933	0	0	0	0	4	0	4
NONE	OG0011934	0	0	0	0	4	0	4
NONE	OG0011935	0	0	0	0	4	0	4
NONE	OG0011936	0	0	0	0	4	0	4
NONE	OG0011937	0	0	0	0	4	0	4
NONE	OG0011938	0	0	0	0	4	0	4
NONE	OG0011939	0	0	0	0	4	0	4
NONE	OG0011940	0	0	0	0	4	0	4
NONE	OG0011941	0	0	0	0	4	0	4
NONE	OG0011942	0	0	0	0	4	0	4
NONE	OG0011943	0	0	0	0	4	0	4
NONE	OG0011944	0	0	0	0	4	0	4
NONE	OG0011945	0	0	0	0	4	0	4
NONE	OG0011946	0	0	0	0	4	0	4
NONE	OG0011947	0	0	0	0	4	0	4
NONE	OG0011948	0	0	0	0	4	0	4
NONE	OG0011949	0	0	0	0	4	0	4
NONE	OG0011950	0	0	0	0	4	0	4
NONE	OG0011951	0	0	0	0	4	0	4
NONE	OG0011952	0	0	0	0	4	0	4
NONE	OG0011953	0	0	0	0	1	3	4
NONE	OG0011954	0	0	0	0	0	4	4
NONE	OG0011955	0	0	0	0	0	4	4
NONE	OG0011956	0	0	0	0	0	4	4
NONE	OG0011957	0	0	0	0	0	4	4
NONE	OG0011958	0	0	0	0	0	4	4
NONE	OG0011959	0	0	0	0	0	4	4
NONE	OG0011960	0	0	0	0	0	4	4
NONE	OG0011961	0	0	0	0	0	4	4
NONE	OG0011962	0	0	0	0	0	4	4
NONE	OG0011963	0	0	0	0	0	4	4
NONE	OG0011964	1	0	2	0	0	0	3
NONE	OG0011965	1	0	1	1	0	0	3
NONE	OG0011966	1	0	2	0	0	0	3
NONE	OG0011967	1	0	1	0	0	1	3
NONE	OG0011968	1	0	1	0	0	1	3
NONE	OG0011969	1	0	1	0	0	1	3
NONE	OG0011970	3	0	0	0	0	0	3
NONE	OG0011971	2	0	1	0	0	0	3
NONE	OG0011972	1	0	2	0	0	0	3
NONE	OG0011973	1	0	1	1	0	0	3
NONE	OG0011974	1	0	2	0	0	0	3
NONE	OG0011975	3	0	0	0	0	0	3
NONE	OG0011976	2	0	0	0	0	1	3
NONE	OG0011977	1	0	1	0	0	1	3
NONE	OG0011978	3	0	0	0	0	0	3
NONE	OG0011979	1	0	1	1	0	0	3
NONE	OG0011980	1	0	1	0	0	1	3
NONE	OG0011981	2	0	1	0	0	0	3
NONE	OG0011982	2	0	1	0	0	0	3
NONE	OG0011983	3	0	0	0	0	0	3
NONE	OG0011984	1	0	2	0	0	0	3
NONE	OG0011985	3	0	0	0	0	0	3
NONE	OG0011986	1	1	1	0	0	0	3
NONE	OG0011987	1	0	2	0	0	0	3
NONE	OG0011988	3	0	0	0	0	0	3
NONE	OG0011989	1	0	1	0	0	1	3
NONE	OG0011990	1	0	1	1	0	0	3
NONE	OG0011991	3	0	0	0	0	0	3
NONE	OG0011992	1	0	1	1	0	0	3
NONE	OG0011993	2	0	1	0	0	0	3
NONE	OG0011994	1	0	2	0	0	0	3
NONE	OG0011995	2	0	1	0	0	0	3
NONE	OG0011996	1	0	1	0	0	1	3
NONE	OG0011997	1	1	0	0	0	1	3
NONE	OG0011998	1	0	2	0	0	0	3
NONE	OG0011999	1	0	1	1	0	0	3
NONE	OG0012000	3	0	0	0	0	0	3
NONE	OG0012001	3	0	0	0	0	0	3
NONE	OG0012002	3	0	0	0	0	0	3
NONE	OG0012003	3	0	0	0	0	0	3
NONE	OG0012004	1	0	1	1	0	0	3
NONE	OG0012005	2	0	1	0	0	0	3
NONE	OG0012006	1	0	0	0	1	1	3
NONE	OG0012007	1	0	1	0	0	1	3
NONE	OG0012008	1	0	1	0	0	1	3
NONE	OG0012009	3	0	0	0	0	0	3
NONE	OG0012010	3	0	0	0	0	0	3
NONE	OG0012011	3	0	0	0	0	0	3
NONE	OG0012012	2	0	0	1	0	0	3
NONE	OG0012013	2	0	1	0	0	0	3
NONE	OG0012014	1	0	0	1	0	1	3
NONE	OG0012015	3	0	0	0	0	0	3
NONE	OG0012016	1	0	1	1	0	0	3
NONE	OG0012017	3	0	0	0	0	0	3
NONE	OG0012018	1	0	1	0	0	1	3
NONE	OG0012019	3	0	0	0	0	0	3
NONE	OG0012020	1	0	1	1	0	0	3
NONE	OG0012021	1	0	1	1	0	0	3
NONE	OG0012022	3	0	0	0	0	0	3
NONE	OG0012023	1	0	0	2	0	0	3
NONE	OG0012024	3	0	0	0	0	0	3
NONE	OG0012025	1	0	1	1	0	0	3
NONE	OG0012026	2	0	1	0	0	0	3
NONE	OG0012027	2	0	1	0	0	0	3
NONE	OG0012028	1	0	1	1	0	0	3
NONE	OG0012029	2	0	1	0	0	0	3
NONE	OG0012030	1	0	1	1	0	0	3
NONE	OG0012031	2	0	1	0	0	0	3
NONE	OG0012032	1	0	0	1	0	1	3
NONE	OG0012033	1	0	1	0	0	1	3
NONE	OG0012034	1	0	0	1	0	1	3
NONE	OG0012035	1	0	0	1	0	1	3
NONE	OG0012036	1	0	2	0	0	0	3
NONE	OG0012037	1	0	2	0	0	0	3
NONE	OG0012038	3	0	0	0	0	0	3
NONE	OG0012039	3	0	0	0	0	0	3
NONE	OG0012040	1	0	0	1	0	1	3
NONE	OG0012041	1	0	2	0	0	0	3
NONE	OG0012042	3	0	0	0	0	0	3
NONE	OG0012043	1	0	1	1	0	0	3
NONE	OG0012044	1	0	1	1	0	0	3
NONE	OG0012045	1	0	2	0	0	0	3
NONE	OG0012046	1	0	1	0	0	1	3
NONE	OG0012047	2	0	1	0	0	0	3
NONE	OG0012048	2	0	0	0	0	1	3
NONE	OG0012049	2	0	1	0	0	0	3
NONE	OG0012050	3	0	0	0	0	0	3
NONE	OG0012051	1	0	1	0	0	1	3
NONE	OG0012052	2	0	1	0	0	0	3
NONE	OG0012053	1	0	2	0	0	0	3
NONE	OG0012054	3	0	0	0	0	0	3
NONE	OG0012055	1	0	0	1	0	1	3
NONE	OG0012056	2	0	1	0	0	0	3
NONE	OG0012057	1	0	1	0	1	0	3
NONE	OG0012058	1	0	2	0	0	0	3
NONE	OG0012059	1	0	0	1	1	0	3
NONE	OG0012060	2	0	1	0	0	0	3
NONE	OG0012061	1	0	1	1	0	0	3
NONE	OG0012062	1	0	1	0	0	1	3
NONE	OG0012063	2	0	0	0	0	1	3
NONE	OG0012064	1	0	1	0	0	1	3
NONE	OG0012065	2	0	0	1	0	0	3
NONE	OG0012066	1	0	2	0	0	0	3
NONE	OG0012067	1	0	1	1	0	0	3
NONE	OG0012068	1	1	1	0	0	0	3
NONE	OG0012069	2	0	0	0	0	1	3
NONE	OG0012070	1	0	1	0	1	0	3
NONE	OG0012071	1	0	2	0	0	0	3
NONE	OG0012072	3	0	0	0	0	0	3
NONE	OG0012073	3	0	0	0	0	0	3
NONE	OG0012074	2	0	0	0	0	1	3
NONE	OG0012075	3	0	0	0	0	0	3
NONE	OG0012076	1	0	1	1	0	0	3
NONE	OG0012077	1	0	1	1	0	0	3
NONE	OG0012078	2	0	1	0	0	0	3
NONE	OG0012079	3	0	0	0	0	0	3
NONE	OG0012080	1	0	0	0	1	1	3
NONE	OG0012081	1	1	1	0	0	0	3
NONE	OG0012082	1	0	1	0	1	0	3
NONE	OG0012083	1	0	1	0	0	1	3
NONE	OG0012084	3	0	0	0	0	0	3
NONE	OG0012085	1	0	0	0	0	2	3
NONE	OG0012086	2	0	1	0	0	0	3
NONE	OG0012087	1	0	2	0	0	0	3
NONE	OG0012088	3	0	0	0	0	0	3
NONE	OG0012089	1	0	1	1	0	0	3
NONE	OG0012090	1	0	0	0	0	2	3
NONE	OG0012091	2	0	1	0	0	0	3
NONE	OG0012092	3	0	0	0	0	0	3
NONE	OG0012093	2	0	1	0	0	0	3
NONE	OG0012094	1	0	1	0	0	1	3
NONE	OG0012095	1	0	1	1	0	0	3
NONE	OG0012096	3	0	0	0	0	0	3
NONE	OG0012097	2	0	1	0	0	0	3
NONE	OG0012098	3	0	0	0	0	0	3
NONE	OG0012099	2	0	1	0	0	0	3
NONE	OG0012100	1	0	1	0	0	1	3
NONE	OG0012101	3	0	0	0	0	0	3
NONE	OG0012102	1	0	1	0	0	1	3
NONE	OG0012103	1	0	1	0	0	1	3
NONE	OG0012104	1	0	1	0	0	1	3
NONE	OG0012105	3	0	0	0	0	0	3
NONE	OG0012106	1	0	1	0	0	1	3
NONE	OG0012107	1	0	1	1	0	0	3
NONE	OG0012108	1	1	1	0	0	0	3
NONE	OG0012109	2	0	1	0	0	0	3
NONE	OG0012110	3	0	0	0	0	0	3
NONE	OG0012111	2	0	0	1	0	0	3
NONE	OG0012112	3	0	0	0	0	0	3
NONE	OG0012113	3	0	0	0	0	0	3
NONE	OG0012114	1	0	1	1	0	0	3
NONE	OG0012115	1	0	1	1	0	0	3
NONE	OG0012116	3	0	0	0	0	0	3
NONE	OG0012117	2	0	1	0	0	0	3
NONE	OG0012118	1	0	1	0	0	1	3
NONE	OG0012119	1	0	2	0	0	0	3
NONE	OG0012120	1	0	0	0	0	2	3
NONE	OG0012121	3	0	0	0	0	0	3
NONE	OG0012122	3	0	0	0	0	0	3
NONE	OG0012123	1	0	2	0	0	0	3
NONE	OG0012124	2	0	0	0	0	1	3
NONE	OG0012125	1	0	1	0	0	1	3
NONE	OG0012126	2	0	0	0	0	1	3
NONE	OG0012127	1	0	1	0	0	1	3
NONE	OG0012128	3	0	0	0	0	0	3
NONE	OG0012129	3	0	0	0	0	0	3
NONE	OG0012130	1	0	1	1	0	0	3
NONE	OG0012131	3	0	0	0	0	0	3
NONE	OG0012132	1	0	2	0	0	0	3
NONE	OG0012133	2	0	0	1	0	0	3
NONE	OG0012134	2	0	1	0	0	0	3
NONE	OG0012135	1	0	2	0	0	0	3
NONE	OG0012136	1	1	0	0	1	0	3
NONE	OG0012137	1	0	1	1	0	0	3
NONE	OG0012138	1	0	1	1	0	0	3
NONE	OG0012139	1	0	1	0	0	1	3
NONE	OG0012140	1	0	1	0	0	1	3
NONE	OG0012141	3	0	0	0	0	0	3
NONE	OG0012142	3	0	0	0	0	0	3
NONE	OG0012143	1	0	2	0	0	0	3
NONE	OG0012144	2	0	1	0	0	0	3
NONE	OG0012145	2	0	1	0	0	0	3
NONE	OG0012146	2	0	0	0	0	1	3
NONE	OG0012147	1	0	2	0	0	0	3
NONE	OG0012148	2	0	1	0	0	0	3
NONE	OG0012149	2	0	1	0	0	0	3
NONE	OG0012150	2	0	0	0	1	0	3
NONE	OG0012151	2	0	1	0	0	0	3
NONE	OG0012152	1	0	1	0	0	1	3
NONE	OG0012153	1	0	1	0	0	1	3
NONE	OG0012154	2	0	1	0	0	0	3
NONE	OG0012155	1	0	1	0	0	1	3
NONE	OG0012156	1	0	1	0	0	1	3
NONE	OG0012157	3	0	0	0	0	0	3
NONE	OG0012158	1	0	1	1	0	0	3
NONE	OG0012159	1	0	2	0	0	0	3
NONE	OG0012160	1	0	1	0	0	1	3
NONE	OG0012161	1	0	1	0	0	1	3
NONE	OG0012162	1	0	1	0	0	1	3
NONE	OG0012163	1	0	1	0	0	1	3
NONE	OG0012164	1	0	2	0	0	0	3
NONE	OG0012165	1	0	2	0	0	0	3
NONE	OG0012166	3	0	0	0	0	0	3
NONE	OG0012167	1	0	1	1	0	0	3
NONE	OG0012168	1	0	2	0	0	0	3
NONE	OG0012169	1	0	1	1	0	0	3
NONE	OG0012170	1	0	2	0	0	0	3
NONE	OG0012171	3	0	0	0	0	0	3
NONE	OG0012172	1	0	1	1	0	0	3
NONE	OG0012173	1	0	2	0	0	0	3
NONE	OG0012174	1	0	1	1	0	0	3
NONE	OG0012175	1	0	0	1	0	1	3
NONE	OG0012176	1	0	0	0	0	2	3
NONE	OG0012177	3	0	0	0	0	0	3
NONE	OG0012178	1	0	0	1	0	1	3
NONE	OG0012179	2	0	0	1	0	0	3
NONE	OG0012180	2	0	0	0	0	1	3
NONE	OG0012181	2	0	0	0	1	0	3
NONE	OG0012182	1	0	0	1	0	1	3
NONE	OG0012183	1	0	1	0	0	1	3
NONE	OG0012184	1	0	1	1	0	0	3
NONE	OG0012185	1	0	2	0	0	0	3
NONE	OG0012186	1	0	1	1	0	0	3
NONE	OG0012187	1	0	0	0	0	2	3
NONE	OG0012188	1	1	1	0	0	0	3
NONE	OG0012189	1	0	0	1	1	0	3
NONE	OG0012190	1	0	1	0	0	1	3
NONE	OG0012191	2	0	1	0	0	0	3
NONE	OG0012192	1	0	1	1	0	0	3
NONE	OG0012193	3	0	0	0	0	0	3
NONE	OG0012194	1	0	1	1	0	0	3
NONE	OG0012195	1	0	1	0	0	1	3
NONE	OG0012196	1	0	2	0	0	0	3
NONE	OG0012197	1	0	1	1	0	0	3
NONE	OG0012198	2	0	0	0	1	0	3
NONE	OG0012199	1	0	1	0	0	1	3
NONE	OG0012200	1	0	2	0	0	0	3
NONE	OG0012201	3	0	0	0	0	0	3
NONE	OG0012202	3	0	0	0	0	0	3
NONE	OG0012203	1	0	1	0	0	1	3
NONE	OG0012204	2	0	1	0	0	0	3
NONE	OG0012205	2	0	1	0	0	0	3
NONE	OG0012206	1	0	1	1	0	0	3
NONE	OG0012207	3	0	0	0	0	0	3
NONE	OG0012208	3	0	0	0	0	0	3
NONE	OG0012209	3	0	0	0	0	0	3
NONE	OG0012210	3	0	0	0	0	0	3
NONE	OG0012211	1	0	0	1	1	0	3
NONE	OG0012212	2	1	0	0	0	0	3
NONE	OG0012213	3	0	0	0	0	0	3
NONE	OG0012214	3	0	0	0	0	0	3
NONE	OG0012215	2	0	1	0	0	0	3
NONE	OG0012216	1	0	2	0	0	0	3
NONE	OG0012217	3	0	0	0	0	0	3
NONE	OG0012218	1	0	1	0	0	1	3
NONE	OG0012219	1	0	1	0	1	0	3
NONE	OG0012220	1	0	2	0	0	0	3
NONE	OG0012221	1	0	1	0	0	1	3
NONE	OG0012222	1	0	2	0	0	0	3
NONE	OG0012223	2	0	1	0	0	0	3
NONE	OG0012224	1	0	1	0	0	1	3
NONE	OG0012225	1	0	1	0	0	1	3
NONE	OG0012226	1	0	2	0	0	0	3
NONE	OG0012227	1	0	1	0	0	1	3
NONE	OG0012228	1	0	1	0	0	1	3
NONE	OG0012229	2	0	1	0	0	0	3
NONE	OG0012230	1	0	2	0	0	0	3
NONE	OG0012231	3	0	0	0	0	0	3
NONE	OG0012232	3	0	0	0	0	0	3
NONE	OG0012233	3	0	0	0	0	0	3
NONE	OG0012234	1	0	1	0	0	1	3
NONE	OG0012235	1	0	0	1	1	0	3
NONE	OG0012236	1	0	0	0	0	2	3
NONE	OG0012237	1	0	1	1	0	0	3
NONE	OG0012238	1	0	1	1	0	0	3
NONE	OG0012239	1	0	0	1	0	1	3
NONE	OG0012240	3	0	0	0	0	0	3
NONE	OG0012241	3	0	0	0	0	0	3
NONE	OG0012242	2	0	0	1	0	0	3
NONE	OG0012243	1	0	2	0	0	0	3
NONE	OG0012244	1	0	1	1	0	0	3
NONE	OG0012245	1	0	1	0	0	1	3
NONE	OG0012246	1	0	1	1	0	0	3
NONE	OG0012247	1	0	1	1	0	0	3
NONE	OG0012248	1	0	1	1	0	0	3
NONE	OG0012249	1	0	1	0	0	1	3
NONE	OG0012250	1	0	1	1	0	0	3
NONE	OG0012251	1	0	1	0	0	1	3
NONE	OG0012252	1	0	1	0	1	0	3
NONE	OG0012253	1	0	1	0	1	0	3
NONE	OG0012254	2	0	0	0	0	1	3
NONE	OG0012255	1	0	1	0	1	0	3
NONE	OG0012256	1	0	1	1	0	0	3
NONE	OG0012257	1	0	1	0	1	0	3
NONE	OG0012258	3	0	0	0	0	0	3
NONE	OG0012259	2	0	1	0	0	0	3
NONE	OG0012260	1	0	0	0	0	2	3
NONE	OG0012261	1	0	1	0	0	1	3
NONE	OG0012262	3	0	0	0	0	0	3
NONE	OG0012263	1	0	2	0	0	0	3
NONE	OG0012264	1	0	2	0	0	0	3
NONE	OG0012265	1	1	0	1	0	0	3
NONE	OG0012266	1	1	1	0	0	0	3
NONE	OG0012267	1	0	1	1	0	0	3
NONE	OG0012268	1	1	0	0	1	0	3
NONE	OG0012269	1	0	1	0	1	0	3
NONE	OG0012270	1	0	1	0	1	0	3
NONE	OG0012271	1	0	0	0	0	2	3
NONE	OG0012272	1	0	1	1	0	0	3
NONE	OG0012273	1	0	1	0	0	1	3
NONE	OG0012274	1	0	1	1	0	0	3
NONE	OG0012275	1	0	1	1	0	0	3
NONE	OG0012276	1	0	0	2	0	0	3
NONE	OG0012277	1	0	1	0	0	1	3
NONE	OG0012278	1	0	1	0	0	1	3
NONE	OG0012279	1	0	1	1	0	0	3
NONE	OG0012280	1	0	2	0	0	0	3
NONE	OG0012281	1	0	1	0	0	1	3
NONE	OG0012282	1	0	1	1	0	0	3
NONE	OG0012283	1	1	1	0	0	0	3
NONE	OG0012284	1	0	2	0	0	0	3
NONE	OG0012285	1	0	1	0	0	1	3
NONE	OG0012286	2	0	1	0	0	0	3
NONE	OG0012287	1	0	1	0	0	1	3
NONE	OG0012288	3	0	0	0	0	0	3
NONE	OG0012289	1	0	1	1	0	0	3
NONE	OG0012290	1	0	2	0	0	0	3
NONE	OG0012291	1	0	1	0	0	1	3
NONE	OG0012292	3	0	0	0	0	0	3
NONE	OG0012293	1	0	2	0	0	0	3
NONE	OG0012294	1	0	1	1	0	0	3
NONE	OG0012295	1	0	1	1	0	0	3
NONE	OG0012296	3	0	0	0	0	0	3
NONE	OG0012297	1	0	1	1	0	0	3
NONE	OG0012298	1	0	1	1	0	0	3
NONE	OG0012299	1	0	1	1	0	0	3
NONE	OG0012300	1	0	2	0	0	0	3
NONE	OG0012301	1	0	2	0	0	0	3
NONE	OG0012302	1	0	1	0	0	1	3
NONE	OG0012303	1	0	0	1	0	1	3
NONE	OG0012304	1	0	1	1	0	0	3
NONE	OG0012305	1	0	1	1	0	0	3
NONE	OG0012306	2	0	1	0	0	0	3
NONE	OG0012307	2	0	1	0	0	0	3
NONE	OG0012308	2	0	1	0	0	0	3
NONE	OG0012309	2	0	0	1	0	0	3
NONE	OG0012310	2	0	0	1	0	0	3
NONE	OG0012311	1	0	1	1	0	0	3
NONE	OG0012312	1	0	1	1	0	0	3
NONE	OG0012313	1	0	1	0	0	1	3
NONE	OG0012314	1	0	1	0	0	1	3
NONE	OG0012315	1	0	1	0	0	1	3
NONE	OG0012316	1	0	1	0	0	1	3
NONE	OG0012317	1	0	1	0	0	1	3
NONE	OG0012318	1	0	1	1	0	0	3
NONE	OG0012319	1	0	1	1	0	0	3
NONE	OG0012320	2	0	1	0	0	0	3
NONE	OG0012321	2	0	1	0	0	0	3
NONE	OG0012322	1	0	0	0	0	2	3
NONE	OG0012323	1	0	0	1	0	1	3
NONE	OG0012324	1	0	1	1	0	0	3
NONE	OG0012325	1	0	0	1	0	1	3
NONE	OG0012326	1	0	1	1	0	0	3
NONE	OG0012327	1	0	1	1	0	0	3
NONE	OG0012328	1	0	0	1	0	1	3
NONE	OG0012329	2	0	0	0	0	1	3
NONE	OG0012330	1	0	1	0	0	1	3
NONE	OG0012331	1	0	1	1	0	0	3
NONE	OG0012332	1	0	1	1	0	0	3
NONE	OG0012333	2	0	1	0	0	0	3
NONE	OG0012334	3	0	0	0	0	0	3
NONE	OG0012335	1	0	1	1	0	0	3
NONE	OG0012336	1	0	1	1	0	0	3
NONE	OG0012337	1	0	2	0	0	0	3
NONE	OG0012338	1	0	1	1	0	0	3
NONE	OG0012339	2	0	0	0	1	0	3
NONE	OG0012340	3	0	0	0	0	0	3
NONE	OG0012341	1	0	1	1	0	0	3
NONE	OG0012342	1	0	1	1	0	0	3
NONE	OG0012343	3	0	0	0	0	0	3
NONE	OG0012344	2	0	1	0	0	0	3
NONE	OG0012345	1	0	1	1	0	0	3
NONE	OG0012346	1	0	1	1	0	0	3
NONE	OG0012347	2	0	1	0	0	0	3
NONE	OG0012348	2	0	1	0	0	0	3
NONE	OG0012349	1	0	2	0	0	0	3
NONE	OG0012350	1	0	2	0	0	0	3
NONE	OG0012351	3	0	0	0	0	0	3
NONE	OG0012352	1	0	1	0	0	1	3
NONE	OG0012353	2	0	0	0	0	1	3
NONE	OG0012354	1	0	1	1	0	0	3
NONE	OG0012355	1	0	1	1	0	0	3
NONE	OG0012356	1	0	1	0	0	1	3
NONE	OG0012357	1	0	1	1	0	0	3
NONE	OG0012358	1	0	2	0	0	0	3
NONE	OG0012359	2	0	1	0	0	0	3
NONE	OG0012360	1	0	0	1	0	1	3
NONE	OG0012361	2	0	1	0	0	0	3
NONE	OG0012362	1	0	1	1	0	0	3
NONE	OG0012363	1	0	1	1	0	0	3
NONE	OG0012364	1	0	1	1	0	0	3
NONE	OG0012365	2	0	1	0	0	0	3
NONE	OG0012366	1	0	1	1	0	0	3
NONE	OG0012367	2	0	0	1	0	0	3
NONE	OG0012368	2	0	1	0	0	0	3
NONE	OG0012369	1	0	2	0	0	0	3
NONE	OG0012370	1	0	2	0	0	0	3
NONE	OG0012371	1	0	1	1	0	0	3
NONE	OG0012372	2	0	1	0	0	0	3
NONE	OG0012373	1	0	1	1	0	0	3
NONE	OG0012374	1	0	1	1	0	0	3
NONE	OG0012375	1	0	1	1	0	0	3
NONE	OG0012376	2	0	1	0	0	0	3
NONE	OG0012377	1	0	1	0	0	1	3
NONE	OG0012378	1	0	1	1	0	0	3
NONE	OG0012379	1	1	1	0	0	0	3
NONE	OG0012380	1	1	1	0	0	0	3
NONE	OG0012381	2	0	1	0	0	0	3
NONE	OG0012382	1	0	1	1	0	0	3
NONE	OG0012383	1	0	2	0	0	0	3
NONE	OG0012384	2	0	1	0	0	0	3
NONE	OG0012385	1	0	1	0	0	1	3
NONE	OG0012386	2	0	1	0	0	0	3
NONE	OG0012387	2	0	1	0	0	0	3
NONE	OG0012388	1	0	2	0	0	0	3
NONE	OG0012389	1	0	0	2	0	0	3
NONE	OG0012390	1	0	1	1	0	0	3
NONE	OG0012391	1	0	2	0	0	0	3
NONE	OG0012392	1	0	1	0	0	1	3
NONE	OG0012393	1	0	2	0	0	0	3
NONE	OG0012394	3	0	0	0	0	0	3
NONE	OG0012395	1	0	2	0	0	0	3
NONE	OG0012396	1	0	1	1	0	0	3
NONE	OG0012397	1	0	2	0	0	0	3
NONE	OG0012398	1	0	1	0	0	1	3
NONE	OG0012399	1	0	1	1	0	0	3
NONE	OG0012400	1	0	1	0	0	1	3
NONE	OG0012401	1	0	1	1	0	0	3
NONE	OG0012402	3	0	0	0	0	0	3
NONE	OG0012403	3	0	0	0	0	0	3
NONE	OG0012404	2	0	1	0	0	0	3
NONE	OG0012405	1	0	1	1	0	0	3
NONE	OG0012406	2	0	1	0	0	0	3
NONE	OG0012407	3	0	0	0	0	0	3
NONE	OG0012408	1	0	2	0	0	0	3
NONE	OG0012409	1	0	1	0	0	1	3
NONE	OG0012410	1	0	1	1	0	0	3
NONE	OG0012411	1	0	1	0	0	1	3
NONE	OG0012412	1	0	1	0	0	1	3
NONE	OG0012413	1	0	1	0	0	1	3
NONE	OG0012414	1	0	1	0	1	0	3
NONE	OG0012415	1	0	1	1	0	0	3
NONE	OG0012416	1	0	1	0	0	1	3
NONE	OG0012417	2	0	1	0	0	0	3
NONE	OG0012418	1	0	0	1	0	1	3
NONE	OG0012419	2	0	1	0	0	0	3
NONE	OG0012420	3	0	0	0	0	0	3
NONE	OG0012421	1	0	1	0	1	0	3
NONE	OG0012422	1	0	0	1	0	1	3
NONE	OG0012423	1	0	1	1	0	0	3
NONE	OG0012424	1	0	1	0	0	1	3
NONE	OG0012425	1	0	0	2	0	0	3
NONE	OG0012426	1	0	1	1	0	0	3
NONE	OG0012427	3	0	0	0	0	0	3
NONE	OG0012428	1	0	1	1	0	0	3
NONE	OG0012429	2	0	0	0	0	1	3
NONE	OG0012430	1	0	1	1	0	0	3
NONE	OG0012431	1	0	0	2	0	0	3
NONE	OG0012432	1	0	1	1	0	0	3
NONE	OG0012433	1	0	1	1	0	0	3
NONE	OG0012434	1	0	0	1	1	0	3
NONE	OG0012435	1	0	1	1	0	0	3
NONE	OG0012436	1	0	1	1	0	0	3
NONE	OG0012437	1	0	2	0	0	0	3
NONE	OG0012438	1	0	1	1	0	0	3
NONE	OG0012439	1	0	1	0	0	1	3
NONE	OG0012440	2	0	1	0	0	0	3
NONE	OG0012441	1	0	1	1	0	0	3
NONE	OG0012442	1	0	1	1	0	0	3
NONE	OG0012443	3	0	0	0	0	0	3
NONE	OG0012444	1	0	2	0	0	0	3
NONE	OG0012445	1	0	0	1	0	1	3
NONE	OG0012446	1	0	1	1	0	0	3
NONE	OG0012447	2	0	0	0	0	1	3
NONE	OG0012448	2	0	0	1	0	0	3
NONE	OG0012449	1	0	1	0	0	1	3
NONE	OG0012450	1	0	2	0	0	0	3
NONE	OG0012451	1	1	0	1	0	0	3
NONE	OG0012452	1	0	1	1	0	0	3
NONE	OG0012453	1	0	1	1	0	0	3
NONE	OG0012454	1	0	1	1	0	0	3
NONE	OG0012455	2	0	1	0	0	0	3
NONE	OG0012456	1	0	1	0	0	1	3
NONE	OG0012457	1	0	1	1	0	0	3
NONE	OG0012458	1	0	1	0	0	1	3
NONE	OG0012459	1	0	2	0	0	0	3
NONE	OG0012460	1	0	1	1	0	0	3
NONE	OG0012461	1	0	1	1	0	0	3
NONE	OG0012462	1	0	1	1	0	0	3
NONE	OG0012463	1	0	2	0	0	0	3
NONE	OG0012464	3	0	0	0	0	0	3
NONE	OG0012465	1	0	1	1	0	0	3
NONE	OG0012466	1	0	1	1	0	0	3
NONE	OG0012467	3	0	0	0	0	0	3
NONE	OG0012468	1	1	1	0	0	0	3
NONE	OG0012469	1	1	0	1	0	0	3
NONE	OG0012470	1	0	2	0	0	0	3
NONE	OG0012471	1	0	1	0	0	1	3
NONE	OG0012472	1	0	1	1	0	0	3
NONE	OG0012473	1	0	0	0	0	2	3
NONE	OG0012474	1	0	1	1	0	0	3
NONE	OG0012475	1	0	0	1	0	1	3
NONE	OG0012476	1	0	1	1	0	0	3
NONE	OG0012477	1	0	1	1	0	0	3
NONE	OG0012478	1	0	1	1	0	0	3
NONE	OG0012479	1	0	1	1	0	0	3
NONE	OG0012480	1	0	1	0	0	1	3
NONE	OG0012481	3	0	0	0	0	0	3
NONE	OG0012482	2	0	0	0	1	0	3
NONE	OG0012483	1	0	2	0	0	0	3
NONE	OG0012484	1	0	0	1	0	1	3
NONE	OG0012485	1	0	1	0	0	1	3
NONE	OG0012486	1	0	1	0	0	1	3
NONE	OG0012487	1	0	1	1	0	0	3
NONE	OG0012488	1	0	1	1	0	0	3
NONE	OG0012489	2	0	1	0	0	0	3
NONE	OG0012490	1	0	1	1	0	0	3
NONE	OG0012491	1	0	0	2	0	0	3
NONE	OG0012492	3	0	0	0	0	0	3
NONE	OG0012493	1	0	1	0	0	1	3
NONE	OG0012494	2	0	1	0	0	0	3
NONE	OG0012495	1	0	1	1	0	0	3
NONE	OG0012496	1	0	2	0	0	0	3
NONE	OG0012497	1	0	2	0	0	0	3
NONE	OG0012498	1	0	1	0	0	1	3
NONE	OG0012499	1	0	0	0	0	2	3
NONE	OG0012500	1	0	2	0	0	0	3
NONE	OG0012501	1	0	2	0	0	0	3
NONE	OG0012502	0	3	0	0	0	0	3
NONE	OG0012503	0	1	1	1	0	0	3
NONE	OG0012504	0	1	0	0	1	1	3
NONE	OG0012505	0	1	1	1	0	0	3
NONE	OG0012506	0	2	0	0	1	0	3
NONE	OG0012507	0	1	1	1	0	0	3
NONE	OG0012508	0	1	0	1	0	1	3
NONE	OG0012509	0	1	1	0	0	1	3
NONE	OG0012510	0	3	0	0	0	0	3
NONE	OG0012511	0	1	0	1	0	1	3
NONE	OG0012512	0	1	1	0	0	1	3
NONE	OG0012513	0	1	0	0	2	0	3
NONE	OG0012514	0	1	0	1	1	0	3
NONE	OG0012515	0	1	0	1	1	0	3
NONE	OG0012516	0	1	0	1	0	1	3
NONE	OG0012517	0	1	0	1	1	0	3
NONE	OG0012518	0	1	1	0	0	1	3
NONE	OG0012519	0	1	1	0	1	0	3
NONE	OG0012520	0	1	0	1	0	1	3
NONE	OG0012521	0	1	1	0	0	1	3
NONE	OG0012522	0	3	0	0	0	0	3
NONE	OG0012523	0	1	1	1	0	0	3
NONE	OG0012524	0	1	0	0	1	1	3
NONE	OG0012525	0	1	1	0	0	1	3
NONE	OG0012526	0	1	0	0	2	0	3
NONE	OG0012527	0	1	0	1	0	1	3
NONE	OG0012528	0	2	0	0	1	0	3
NONE	OG0012529	0	1	0	1	0	1	3
NONE	OG0012530	0	1	1	0	0	1	3
NONE	OG0012531	0	2	0	1	0	0	3
NONE	OG0012532	0	0	3	0	0	0	3
NONE	OG0012533	0	0	3	0	0	0	3
NONE	OG0012534	0	0	3	0	0	0	3
NONE	OG0012535	0	0	1	0	0	2	3
NONE	OG0012536	0	0	2	0	1	0	3
NONE	OG0012537	0	0	1	1	0	1	3
NONE	OG0012538	0	0	3	0	0	0	3
NONE	OG0012539	0	0	3	0	0	0	3
NONE	OG0012540	0	0	3	0	0	0	3
NONE	OG0012541	0	0	1	1	0	1	3
NONE	OG0012542	0	0	3	0	0	0	3
NONE	OG0012543	0	0	3	0	0	0	3
NONE	OG0012544	0	0	1	0	0	2	3
NONE	OG0012545	0	0	3	0	0	0	3
NONE	OG0012546	0	0	2	0	0	1	3
NONE	OG0012547	0	0	1	1	0	1	3
NONE	OG0012548	0	0	1	1	1	0	3
NONE	OG0012549	0	0	3	0	0	0	3
NONE	OG0012550	0	0	3	0	0	0	3
NONE	OG0012551	0	0	3	0	0	0	3
NONE	OG0012552	0	0	1	0	0	2	3
NONE	OG0012553	0	0	2	0	0	1	3
NONE	OG0012554	0	0	1	1	0	1	3
NONE	OG0012555	0	0	3	0	0	0	3
NONE	OG0012556	0	0	3	0	0	0	3
NONE	OG0012557	0	0	3	0	0	0	3
NONE	OG0012558	0	0	3	0	0	0	3
NONE	OG0012559	0	0	3	0	0	0	3
NONE	OG0012560	0	0	1	1	0	1	3
NONE	OG0012561	0	0	1	1	0	1	3
NONE	OG0012562	0	0	2	0	0	1	3
NONE	OG0012563	0	0	3	0	0	0	3
NONE	OG0012564	0	0	3	0	0	0	3
NONE	OG0012565	0	0	2	0	0	1	3
NONE	OG0012566	0	0	1	1	0	1	3
NONE	OG0012567	0	0	1	1	0	1	3
NONE	OG0012568	0	0	1	1	0	1	3
NONE	OG0012569	0	0	1	1	0	1	3
NONE	OG0012570	0	0	1	0	0	2	3
NONE	OG0012571	0	0	2	0	0	1	3
NONE	OG0012572	0	0	1	1	0	1	3
NONE	OG0012573	0	0	3	0	0	0	3
NONE	OG0012574	0	0	3	0	0	0	3
NONE	OG0012575	0	0	3	0	0	0	3
NONE	OG0012576	0	0	1	0	0	2	3
NONE	OG0012577	0	0	3	0	0	0	3
NONE	OG0012578	0	0	3	0	0	0	3
NONE	OG0012579	0	0	3	0	0	0	3
NONE	OG0012580	0	0	3	0	0	0	3
NONE	OG0012581	0	0	3	0	0	0	3
NONE	OG0012582	0	0	3	0	0	0	3
NONE	OG0012583	0	0	2	0	0	1	3
NONE	OG0012584	0	0	2	0	0	1	3
NONE	OG0012585	0	0	1	1	0	1	3
NONE	OG0012586	0	0	1	0	0	2	3
NONE	OG0012587	0	0	1	1	1	0	3
NONE	OG0012588	0	0	1	0	0	2	3
NONE	OG0012589	0	0	3	0	0	0	3
NONE	OG0012590	0	0	1	1	0	1	3
NONE	OG0012591	0	0	1	1	0	1	3
NONE	OG0012592	0	0	1	1	0	1	3
NONE	OG0012593	0	0	1	1	0	1	3
NONE	OG0012594	0	0	3	0	0	0	3
NONE	OG0012595	0	0	3	0	0	0	3
NONE	OG0012596	0	0	3	0	0	0	3
NONE	OG0012597	0	0	1	1	0	1	3
NONE	OG0012598	0	0	2	0	0	1	3
NONE	OG0012599	0	0	3	0	0	0	3
NONE	OG0012600	0	0	3	0	0	0	3
NONE	OG0012601	0	0	2	0	0	1	3
NONE	OG0012602	0	0	1	1	0	1	3
NONE	OG0012603	0	0	3	0	0	0	3
NONE	OG0012604	0	0	2	0	0	1	3
NONE	OG0012605	0	0	1	1	0	1	3
NONE	OG0012606	0	0	3	0	0	0	3
NONE	OG0012607	0	0	3	0	0	0	3
NONE	OG0012608	0	0	3	0	0	0	3
NONE	OG0012609	0	0	2	1	0	0	3
NONE	OG0012610	0	0	3	0	0	0	3
NONE	OG0012611	0	0	3	0	0	0	3
NONE	OG0012612	0	0	3	0	0	0	3
NONE	OG0012613	0	0	1	0	0	2	3
NONE	OG0012614	0	0	1	1	0	1	3
NONE	OG0012615	0	0	1	1	0	1	3
NONE	OG0012616	0	0	1	1	0	1	3
NONE	OG0012617	0	0	3	0	0	0	3
NONE	OG0012618	0	0	1	0	0	2	3
NONE	OG0012619	0	0	1	1	1	0	3
NONE	OG0012620	0	0	1	2	0	0	3
NONE	OG0012621	0	0	1	1	0	1	3
NONE	OG0012622	0	0	1	0	0	2	3
NONE	OG0012623	0	0	1	1	0	1	3
NONE	OG0012624	0	0	1	1	0	1	3
NONE	OG0012625	0	0	1	0	0	2	3
NONE	OG0012626	0	0	3	0	0	0	3
NONE	OG0012627	0	0	3	0	0	0	3
NONE	OG0012628	0	0	1	1	0	1	3
NONE	OG0012629	0	0	1	1	1	0	3
NONE	OG0012630	0	0	3	0	0	0	3
NONE	OG0012631	0	0	1	1	0	1	3
NONE	OG0012632	0	0	3	0	0	0	3
NONE	OG0012633	0	0	2	0	0	1	3
NONE	OG0012634	0	0	1	0	0	2	3
NONE	OG0012635	0	0	1	0	0	2	3
NONE	OG0012636	0	0	1	1	0	1	3
NONE	OG0012637	0	0	1	2	0	0	3
NONE	OG0012638	0	0	3	0	0	0	3
NONE	OG0012639	0	0	3	0	0	0	3
NONE	OG0012640	0	0	1	0	0	2	3
NONE	OG0012641	0	0	3	0	0	0	3
NONE	OG0012642	0	0	1	0	0	2	3
NONE	OG0012643	0	0	3	0	0	0	3
NONE	OG0012644	0	0	1	2	0	0	3
NONE	OG0012645	0	0	3	0	0	0	3
NONE	OG0012646	0	0	3	0	0	0	3
NONE	OG0012647	0	0	3	0	0	0	3
NONE	OG0012648	0	0	1	1	0	1	3
NONE	OG0012649	0	0	3	0	0	0	3
NONE	OG0012650	0	0	1	0	0	2	3
NONE	OG0012651	0	0	1	0	0	2	3
NONE	OG0012652	0	0	3	0	0	0	3
NONE	OG0012653	0	0	1	1	0	1	3
NONE	OG0012654	0	0	1	1	0	1	3
NONE	OG0012655	0	0	1	2	0	0	3
NONE	OG0012656	0	0	1	1	0	1	3
NONE	OG0012657	0	0	1	1	0	1	3
NONE	OG0012658	0	0	1	0	1	1	3
NONE	OG0012659	0	0	1	1	0	1	3
NONE	OG0012660	0	0	1	0	0	2	3
NONE	OG0012661	0	0	1	1	0	1	3
NONE	OG0012662	0	0	1	1	0	1	3
NONE	OG0012663	0	0	3	0	0	0	3
NONE	OG0012664	0	0	0	1	1	1	3
NONE	OG0012665	0	0	0	3	0	0	3
NONE	OG0012666	0	0	0	3	0	0	3
NONE	OG0012667	0	0	0	3	0	0	3
NONE	OG0012668	0	0	0	3	0	0	3
NONE	OG0012669	0	0	0	3	0	0	3
NONE	OG0012670	0	0	0	3	0	0	3
NONE	OG0012671	0	0	0	3	0	0	3
NONE	OG0012672	0	0	0	3	0	0	3
NONE	OG0012673	0	0	0	3	0	0	3
NONE	OG0012674	0	0	0	3	0	0	3
NONE	OG0012675	0	0	0	3	0	0	3
NONE	OG0012676	0	0	0	3	0	0	3
NONE	OG0012677	0	0	0	3	0	0	3
NONE	OG0012678	0	0	0	3	0	0	3
NONE	OG0012679	0	0	0	3	0	0	3
NONE	OG0012680	0	0	0	1	0	2	3
NONE	OG0012681	0	0	0	3	0	0	3
NONE	OG0012682	0	0	0	3	0	0	3
NONE	OG0012683	0	0	0	3	0	0	3
NONE	OG0012684	0	0	0	3	0	0	3
NONE	OG0012685	0	0	0	3	0	0	3
NONE	OG0012686	0	0	0	3	0	0	3
NONE	OG0012687	0	0	0	3	0	0	3
NONE	OG0012688	0	0	0	3	0	0	3
NONE	OG0012689	0	0	0	2	0	1	3
NONE	OG0012690	0	0	0	3	0	0	3
NONE	OG0012691	0	0	0	3	0	0	3
NONE	OG0012692	0	0	0	3	0	0	3
NONE	OG0012693	0	0	0	3	0	0	3
NONE	OG0012694	0	0	0	1	1	1	3
NONE	OG0012695	0	0	0	3	0	0	3
NONE	OG0012696	0	0	0	3	0	0	3
NONE	OG0012697	0	0	0	3	0	0	3
NONE	OG0012698	0	0	0	3	0	0	3
NONE	OG0012699	0	0	0	3	0	0	3
NONE	OG0012700	0	0	0	1	1	1	3
NONE	OG0012701	0	0	0	3	0	0	3
NONE	OG0012702	0	0	0	3	0	0	3
NONE	OG0012703	0	0	0	3	0	0	3
NONE	OG0012704	0	0	0	3	0	0	3
NONE	OG0012705	0	0	0	1	0	2	3
NONE	OG0012706	0	0	0	1	0	2	3
NONE	OG0012707	0	0	0	3	0	0	3
NONE	OG0012708	0	0	0	3	0	0	3
NONE	OG0012709	0	0	0	2	0	1	3
NONE	OG0012710	0	0	0	3	0	0	3
NONE	OG0012711	0	0	0	3	0	0	3
NONE	OG0012712	0	0	0	1	0	2	3
NONE	OG0012713	0	0	0	3	0	0	3
NONE	OG0012714	0	0	0	1	1	1	3
NONE	OG0012715	0	0	0	1	1	1	3
NONE	OG0012716	0	0	0	3	0	0	3
NONE	OG0012717	0	0	0	2	0	1	3
NONE	OG0012718	0	0	0	3	0	0	3
NONE	OG0012719	0	0	0	3	0	0	3
NONE	OG0012720	0	0	0	3	0	0	3
NONE	OG0012721	0	0	0	3	0	0	3
NONE	OG0012722	0	0	0	3	0	0	3
NONE	OG0012723	0	0	0	1	1	1	3
NONE	OG0012724	0	0	0	3	0	0	3
NONE	OG0012725	0	0	0	1	1	1	3
NONE	OG0012726	0	0	0	1	0	2	3
NONE	OG0012727	0	0	0	1	1	1	3
NONE	OG0012728	0	0	0	3	0	0	3
NONE	OG0012729	0	0	0	3	0	0	3
NONE	OG0012730	0	0	0	1	0	2	3
NONE	OG0012731	0	0	0	3	0	0	3
NONE	OG0012732	0	0	0	1	1	1	3
NONE	OG0012733	0	0	0	3	0	0	3
NONE	OG0012734	0	0	0	1	1	1	3
NONE	OG0012735	0	0	0	3	0	0	3
NONE	OG0012736	0	0	0	2	0	1	3
NONE	OG0012737	0	0	0	3	0	0	3
NONE	OG0012738	0	0	0	3	0	0	3
NONE	OG0012739	0	0	0	3	0	0	3
NONE	OG0012740	0	0	0	3	0	0	3
NONE	OG0012741	0	0	0	3	0	0	3
NONE	OG0012742	0	0	0	1	0	2	3
NONE	OG0012743	0	0	0	3	0	0	3
NONE	OG0012744	0	0	0	3	0	0	3
NONE	OG0012745	0	0	0	1	2	0	3
NONE	OG0012746	0	0	0	3	0	0	3
NONE	OG0012747	0	0	0	3	0	0	3
NONE	OG0012748	0	0	0	3	0	0	3
NONE	OG0012749	0	0	0	2	0	1	3
NONE	OG0012750	0	0	0	3	0	0	3
NONE	OG0012751	0	0	0	3	0	0	3
NONE	OG0012752	0	0	0	3	0	0	3
NONE	OG0012753	0	0	0	3	0	0	3
NONE	OG0012754	0	0	0	3	0	0	3
NONE	OG0012755	0	0	0	3	0	0	3
NONE	OG0012756	0	0	0	1	1	1	3
NONE	OG0012757	0	0	0	0	3	0	3
NONE	OG0012758	0	0	0	0	3	0	3
NONE	OG0012759	0	0	0	0	3	0	3
NONE	OG0012760	0	0	0	0	3	0	3
NONE	OG0012761	0	0	0	0	3	0	3
NONE	OG0012762	0	0	0	0	3	0	3
NONE	OG0012763	0	0	0	0	3	0	3
NONE	OG0012764	0	0	0	0	3	0	3
NONE	OG0012765	0	0	0	0	3	0	3
NONE	OG0012766	0	0	0	0	3	0	3
NONE	OG0012767	0	0	0	0	3	0	3
NONE	OG0012768	0	0	0	0	3	0	3
NONE	OG0012769	0	0	0	0	3	0	3
NONE	OG0012770	0	0	0	0	3	0	3
NONE	OG0012771	0	0	0	0	3	0	3
NONE	OG0012772	0	0	0	0	3	0	3
NONE	OG0012773	0	0	0	0	3	0	3
NONE	OG0012774	0	0	0	0	3	0	3
NONE	OG0012775	0	0	0	0	3	0	3
NONE	OG0012776	0	0	0	0	3	0	3
NONE	OG0012777	0	0	0	0	3	0	3
NONE	OG0012778	0	0	0	0	3	0	3
NONE	OG0012779	0	0	0	0	3	0	3
NONE	OG0012780	0	0	0	0	3	0	3
NONE	OG0012781	0	0	0	0	3	0	3
NONE	OG0012782	0	0	0	0	3	0	3
NONE	OG0012783	0	0	0	0	3	0	3
NONE	OG0012784	0	0	0	0	3	0	3
NONE	OG0012785	0	0	0	0	3	0	3
NONE	OG0012786	0	0	0	0	3	0	3
NONE	OG0012787	0	0	0	0	3	0	3
NONE	OG0012788	0	0	0	0	3	0	3
NONE	OG0012789	0	0	0	0	3	0	3
NONE	OG0012790	0	0	0	0	3	0	3
NONE	OG0012791	0	0	0	0	3	0	3
NONE	OG0012792	0	0	0	0	3	0	3
NONE	OG0012793	0	0	0	0	3	0	3
NONE	OG0012794	0	0	0	0	3	0	3
NONE	OG0012795	0	0	0	0	3	0	3
NONE	OG0012796	0	0	0	0	3	0	3
NONE	OG0012797	0	0	0	0	3	0	3
NONE	OG0012798	0	0	0	0	3	0	3
NONE	OG0012799	0	0	0	0	3	0	3
NONE	OG0012800	0	0	0	0	0	3	3
NONE	OG0012801	0	0	0	0	0	3	3
NONE	OG0012802	0	0	0	0	0	3	3
NONE	OG0012803	0	0	0	0	0	3	3
NONE	OG0012804	0	0	0	0	0	3	3
NONE	OG0012805	0	0	0	0	0	3	3
NONE	OG0012806	0	0	0	0	0	3	3
NONE	OG0012807	0	0	0	0	0	3	3
NONE	OG0012808	0	0	0	0	0	3	3
NONE	OG0012809	0	0	0	0	0	3	3
NONE	OG0012810	0	0	0	0	0	3	3
NONE	OG0012811	0	0	0	0	0	3	3
NONE	OG0012812	0	0	0	0	0	3	3
NONE	OG0012813	0	0	0	0	0	3	3
NONE	OG0012814	0	0	0	0	0	3	3
NONE	OG0012815	0	0	0	0	0	3	3
NONE	OG0012816	0	0	0	0	0	3	3
NONE	OG0012817	0	0	0	0	0	3	3
NONE	OG0012818	0	0	0	0	0	3	3
NONE	OG0012819	0	0	0	0	0	3	3
NONE	OG0012820	0	0	0	0	0	3	3
NONE	OG0012821	0	0	0	0	0	3	3
NONE	OG0012822	0	0	0	0	0	3	3
NONE	OG0012823	0	0	0	0	0	3	3
NONE	OG0012824	0	0	0	0	0	3	3
NONE	OG0012825	0	0	0	0	0	3	3
NONE	OG0012826	0	0	0	0	0	3	3
NONE	OG0012827	0	0	0	0	0	3	3
NONE	OG0012828	2	0	0	0	0	0	2
NONE	OG0012829	1	0	0	0	0	1	2
NONE	OG0012830	2	0	0	0	0	0	2
NONE	OG0012831	2	0	0	0	0	0	2
NONE	OG0012832	1	0	1	0	0	0	2
NONE	OG0012833	1	0	1	0	0	0	2
NONE	OG0012834	2	0	0	0	0	0	2
NONE	OG0012835	2	0	0	0	0	0	2
NONE	OG0012836	1	0	1	0	0	0	2
NONE	OG0012837	1	0	1	0	0	0	2
NONE	OG0012838	1	0	1	0	0	0	2
NONE	OG0012839	2	0	0	0	0	0	2
NONE	OG0012840	1	0	1	0	0	0	2
NONE	OG0012841	1	0	1	0	0	0	2
NONE	OG0012842	1	0	0	0	0	1	2
NONE	OG0012843	1	0	1	0	0	0	2
NONE	OG0012844	1	0	0	1	0	0	2
NONE	OG0012845	2	0	0	0	0	0	2
NONE	OG0012846	1	0	1	0	0	0	2
NONE	OG0012847	1	0	0	0	0	1	2
NONE	OG0012848	1	0	0	1	0	0	2
NONE	OG0012849	1	0	1	0	0	0	2
NONE	OG0012850	2	0	0	0	0	0	2
NONE	OG0012851	1	0	0	1	0	0	2
NONE	OG0012852	2	0	0	0	0	0	2
NONE	OG0012853	2	0	0	0	0	0	2
NONE	OG0012854	2	0	0	0	0	0	2
NONE	OG0012855	1	0	1	0	0	0	2
NONE	OG0012856	1	0	1	0	0	0	2
NONE	OG0012857	1	0	1	0	0	0	2
NONE	OG0012858	2	0	0	0	0	0	2
NONE	OG0012859	1	0	1	0	0	0	2
NONE	OG0012860	1	0	1	0	0	0	2
NONE	OG0012861	1	0	0	1	0	0	2
NONE	OG0012862	1	0	0	1	0	0	2
NONE	OG0012863	2	0	0	0	0	0	2
NONE	OG0012864	1	0	1	0	0	0	2
NONE	OG0012865	2	0	0	0	0	0	2
NONE	OG0012866	2	0	0	0	0	0	2
NONE	OG0012867	2	0	0	0	0	0	2
NONE	OG0012868	1	0	1	0	0	0	2
NONE	OG0012869	1	0	1	0	0	0	2
NONE	OG0012870	2	0	0	0	0	0	2
NONE	OG0012871	2	0	0	0	0	0	2
NONE	OG0012872	1	0	1	0	0	0	2
NONE	OG0012873	2	0	0	0	0	0	2
NONE	OG0012874	1	0	1	0	0	0	2
NONE	OG0012875	2	0	0	0	0	0	2
NONE	OG0012876	1	0	1	0	0	0	2
NONE	OG0012877	2	0	0	0	0	0	2
NONE	OG0012878	1	0	1	0	0	0	2
NONE	OG0012879	2	0	0	0	0	0	2
NONE	OG0012880	2	0	0	0	0	0	2
NONE	OG0012881	1	0	1	0	0	0	2
NONE	OG0012882	1	0	1	0	0	0	2
NONE	OG0012883	1	0	1	0	0	0	2
NONE	OG0012884	1	0	0	1	0	0	2
NONE	OG0012885	1	0	0	0	0	1	2
NONE	OG0012886	1	0	1	0	0	0	2
NONE	OG0012887	2	0	0	0	0	0	2
NONE	OG0012888	2	0	0	0	0	0	2
NONE	OG0012889	1	0	1	0	0	0	2
NONE	OG0012890	2	0	0	0	0	0	2
NONE	OG0012891	2	0	0	0	0	0	2
NONE	OG0012892	1	0	0	1	0	0	2
NONE	OG0012893	1	0	1	0	0	0	2
NONE	OG0012894	1	0	1	0	0	0	2
NONE	OG0012895	2	0	0	0	0	0	2
NONE	OG0012896	2	0	0	0	0	0	2
NONE	OG0012897	1	0	1	0	0	0	2
NONE	OG0012898	2	0	0	0	0	0	2
NONE	OG0012899	1	0	0	0	0	1	2
NONE	OG0012900	2	0	0	0	0	0	2
NONE	OG0012901	1	0	1	0	0	0	2
NONE	OG0012902	1	0	1	0	0	0	2
NONE	OG0012903	1	0	1	0	0	0	2
NONE	OG0012904	1	0	1	0	0	0	2
NONE	OG0012905	2	0	0	0	0	0	2
NONE	OG0012906	2	0	0	0	0	0	2
NONE	OG0012907	1	0	1	0	0	0	2
NONE	OG0012908	2	0	0	0	0	0	2
NONE	OG0012909	1	0	1	0	0	0	2
NONE	OG0012910	2	0	0	0	0	0	2
NONE	OG0012911	1	0	1	0	0	0	2
NONE	OG0012912	2	0	0	0	0	0	2
NONE	OG0012913	2	0	0	0	0	0	2
NONE	OG0012914	1	1	0	0	0	0	2
NONE	OG0012915	2	0	0	0	0	0	2
NONE	OG0012916	1	0	1	0	0	0	2
NONE	OG0012917	2	0	0	0	0	0	2
NONE	OG0012918	1	0	1	0	0	0	2
NONE	OG0012919	2	0	0	0	0	0	2
NONE	OG0012920	1	0	0	1	0	0	2
NONE	OG0012921	1	0	0	1	0	0	2
NONE	OG0012922	2	0	0	0	0	0	2
NONE	OG0012923	1	0	1	0	0	0	2
NONE	OG0012924	1	0	1	0	0	0	2
NONE	OG0012925	2	0	0	0	0	0	2
NONE	OG0012926	2	0	0	0	0	0	2
NONE	OG0012927	1	0	1	0	0	0	2
NONE	OG0012928	1	0	1	0	0	0	2
NONE	OG0012929	1	0	1	0	0	0	2
NONE	OG0012930	2	0	0	0	0	0	2
NONE	OG0012931	1	0	1	0	0	0	2
NONE	OG0012932	2	0	0	0	0	0	2
NONE	OG0012933	1	0	1	0	0	0	2
NONE	OG0012934	1	0	1	0	0	0	2
NONE	OG0012935	1	0	1	0	0	0	2
NONE	OG0012936	2	0	0	0	0	0	2
NONE	OG0012937	1	0	0	0	1	0	2
NONE	OG0012938	1	0	1	0	0	0	2
NONE	OG0012939	2	0	0	0	0	0	2
NONE	OG0012940	1	0	1	0	0	0	2
NONE	OG0012941	2	0	0	0	0	0	2
NONE	OG0012942	2	0	0	0	0	0	2
NONE	OG0012943	1	1	0	0	0	0	2
NONE	OG0012944	2	0	0	0	0	0	2
NONE	OG0012945	2	0	0	0	0	0	2
NONE	OG0012946	2	0	0	0	0	0	2
NONE	OG0012947	1	0	1	0	0	0	2
NONE	OG0012948	1	0	1	0	0	0	2
NONE	OG0012949	1	0	1	0	0	0	2
NONE	OG0012950	1	0	0	1	0	0	2
NONE	OG0012951	2	0	0	0	0	0	2
NONE	OG0012952	2	0	0	0	0	0	2
NONE	OG0012953	2	0	0	0	0	0	2
NONE	OG0012954	2	0	0	0	0	0	2
NONE	OG0012955	1	0	1	0	0	0	2
NONE	OG0012956	1	0	0	1	0	0	2
NONE	OG0012957	2	0	0	0	0	0	2
NONE	OG0012958	1	0	0	0	0	1	2
NONE	OG0012959	1	0	1	0	0	0	2
NONE	OG0012960	1	0	1	0	0	0	2
NONE	OG0012961	1	0	1	0	0	0	2
NONE	OG0012962	1	0	1	0	0	0	2
NONE	OG0012963	2	0	0	0	0	0	2
NONE	OG0012964	2	0	0	0	0	0	2
NONE	OG0012965	1	0	1	0	0	0	2
NONE	OG0012966	1	0	1	0	0	0	2
NONE	OG0012967	2	0	0	0	0	0	2
NONE	OG0012968	2	0	0	0	0	0	2
NONE	OG0012969	1	0	1	0	0	0	2
NONE	OG0012970	1	0	0	0	0	1	2
NONE	OG0012971	2	0	0	0	0	0	2
NONE	OG0012972	1	0	1	0	0	0	2
NONE	OG0012973	2	0	0	0	0	0	2
NONE	OG0012974	2	0	0	0	0	0	2
NONE	OG0012975	1	0	1	0	0	0	2
NONE	OG0012976	1	0	1	0	0	0	2
NONE	OG0012977	1	0	1	0	0	0	2
NONE	OG0012978	1	0	1	0	0	0	2
NONE	OG0012979	2	0	0	0	0	0	2
NONE	OG0012980	1	0	1	0	0	0	2
NONE	OG0012981	2	0	0	0	0	0	2
NONE	OG0012982	1	0	0	1	0	0	2
NONE	OG0012983	1	0	1	0	0	0	2
NONE	OG0012984	2	0	0	0	0	0	2
NONE	OG0012985	1	0	1	0	0	0	2
NONE	OG0012986	2	0	0	0	0	0	2
NONE	OG0012987	1	0	1	0	0	0	2
NONE	OG0012988	1	0	1	0	0	0	2
NONE	OG0012989	1	0	1	0	0	0	2
NONE	OG0012990	2	0	0	0	0	0	2
NONE	OG0012991	1	0	1	0	0	0	2
NONE	OG0012992	1	0	1	0	0	0	2
NONE	OG0012993	2	0	0	0	0	0	2
NONE	OG0012994	2	0	0	0	0	0	2
NONE	OG0012995	1	0	1	0	0	0	2
NONE	OG0012996	1	0	1	0	0	0	2
NONE	OG0012997	1	0	0	1	0	0	2
NONE	OG0012998	2	0	0	0	0	0	2
NONE	OG0012999	1	0	1	0	0	0	2
NONE	OG0013000	1	0	1	0	0	0	2
NONE	OG0013001	1	0	1	0	0	0	2
NONE	OG0013002	1	0	1	0	0	0	2
NONE	OG0013003	2	0	0	0	0	0	2
NONE	OG0013004	1	0	1	0	0	0	2
NONE	OG0013005	1	0	1	0	0	0	2
NONE	OG0013006	1	0	1	0	0	0	2
NONE	OG0013007	2	0	0	0	0	0	2
NONE	OG0013008	2	0	0	0	0	0	2
NONE	OG0013009	2	0	0	0	0	0	2
NONE	OG0013010	1	0	1	0	0	0	2
NONE	OG0013011	1	0	1	0	0	0	2
NONE	OG0013012	2	0	0	0	0	0	2
NONE	OG0013013	1	0	1	0	0	0	2
NONE	OG0013014	2	0	0	0	0	0	2
NONE	OG0013015	1	0	1	0	0	0	2
NONE	OG0013016	1	0	1	0	0	0	2
NONE	OG0013017	1	0	1	0	0	0	2
NONE	OG0013018	2	0	0	0	0	0	2
NONE	OG0013019	2	0	0	0	0	0	2
NONE	OG0013020	1	0	1	0	0	0	2
NONE	OG0013021	2	0	0	0	0	0	2
NONE	OG0013022	1	0	1	0	0	0	2
NONE	OG0013023	2	0	0	0	0	0	2
NONE	OG0013024	1	0	1	0	0	0	2
NONE	OG0013025	1	0	1	0	0	0	2
NONE	OG0013026	1	0	1	0	0	0	2
NONE	OG0013027	2	0	0	0	0	0	2
NONE	OG0013028	2	0	0	0	0	0	2
NONE	OG0013029	1	0	1	0	0	0	2
NONE	OG0013030	2	0	0	0	0	0	2
NONE	OG0013031	1	0	0	0	0	1	2
NONE	OG0013032	1	0	1	0	0	0	2
NONE	OG0013033	1	0	1	0	0	0	2
NONE	OG0013034	1	0	1	0	0	0	2
NONE	OG0013035	2	0	0	0	0	0	2
NONE	OG0013036	2	0	0	0	0	0	2
NONE	OG0013037	2	0	0	0	0	0	2
NONE	OG0013038	1	0	0	1	0	0	2
NONE	OG0013039	2	0	0	0	0	0	2
NONE	OG0013040	2	0	0	0	0	0	2
NONE	OG0013041	2	0	0	0	0	0	2
NONE	OG0013042	1	0	0	0	0	1	2
NONE	OG0013043	1	0	0	1	0	0	2
NONE	OG0013044	2	0	0	0	0	0	2
NONE	OG0013045	2	0	0	0	0	0	2
NONE	OG0013046	1	0	1	0	0	0	2
NONE	OG0013047	1	0	1	0	0	0	2
NONE	OG0013048	2	0	0	0	0	0	2
NONE	OG0013049	1	0	1	0	0	0	2
NONE	OG0013050	2	0	0	0	0	0	2
NONE	OG0013051	2	0	0	0	0	0	2
NONE	OG0013052	1	0	1	0	0	0	2
NONE	OG0013053	2	0	0	0	0	0	2
NONE	OG0013054	2	0	0	0	0	0	2
NONE	OG0013055	2	0	0	0	0	0	2
NONE	OG0013056	1	0	0	0	1	0	2
NONE	OG0013057	1	0	1	0	0	0	2
NONE	OG0013058	1	0	1	0	0	0	2
NONE	OG0013059	1	0	1	0	0	0	2
NONE	OG0013060	1	1	0	0	0	0	2
NONE	OG0013061	2	0	0	0	0	0	2
NONE	OG0013062	2	0	0	0	0	0	2
NONE	OG0013063	1	0	1	0	0	0	2
NONE	OG0013064	1	0	1	0	0	0	2
NONE	OG0013065	2	0	0	0	0	0	2
NONE	OG0013066	2	0	0	0	0	0	2
NONE	OG0013067	1	0	1	0	0	0	2
NONE	OG0013068	1	0	0	0	0	1	2
NONE	OG0013069	2	0	0	0	0	0	2
NONE	OG0013070	1	0	1	0	0	0	2
NONE	OG0013071	1	0	1	0	0	0	2
NONE	OG0013072	1	0	0	0	0	1	2
NONE	OG0013073	1	0	1	0	0	0	2
NONE	OG0013074	1	0	0	1	0	0	2
NONE	OG0013075	1	0	1	0	0	0	2
NONE	OG0013076	1	0	0	0	0	1	2
NONE	OG0013077	1	0	1	0	0	0	2
NONE	OG0013078	1	0	0	0	0	1	2
NONE	OG0013079	2	0	0	0	0	0	2
NONE	OG0013080	1	0	1	0	0	0	2
NONE	OG0013081	2	0	0	0	0	0	2
NONE	OG0013082	2	0	0	0	0	0	2
NONE	OG0013083	1	0	1	0	0	0	2
NONE	OG0013084	1	0	0	1	0	0	2
NONE	OG0013085	2	0	0	0	0	0	2
NONE	OG0013086	2	0	0	0	0	0	2
NONE	OG0013087	2	0	0	0	0	0	2
NONE	OG0013088	2	0	0	0	0	0	2
NONE	OG0013089	2	0	0	0	0	0	2
NONE	OG0013090	2	0	0	0	0	0	2
NONE	OG0013091	1	0	1	0	0	0	2
NONE	OG0013092	1	0	0	0	1	0	2
NONE	OG0013093	1	0	0	1	0	0	2
NONE	OG0013094	1	0	1	0	0	0	2
NONE	OG0013095	2	0	0	0	0	0	2
NONE	OG0013096	2	0	0	0	0	0	2
NONE	OG0013097	2	0	0	0	0	0	2
NONE	OG0013098	1	0	0	0	0	1	2
NONE	OG0013099	2	0	0	0	0	0	2
NONE	OG0013100	2	0	0	0	0	0	2
NONE	OG0013101	1	0	0	1	0	0	2
NONE	OG0013102	1	0	0	0	0	1	2
NONE	OG0013103	1	0	1	0	0	0	2
NONE	OG0013104	2	0	0	0	0	0	2
NONE	OG0013105	1	0	0	1	0	0	2
NONE	OG0013106	1	0	0	0	0	1	2
NONE	OG0013107	2	0	0	0	0	0	2
NONE	OG0013108	1	0	1	0	0	0	2
NONE	OG0013109	2	0	0	0	0	0	2
NONE	OG0013110	1	0	1	0	0	0	2
NONE	OG0013111	2	0	0	0	0	0	2
NONE	OG0013112	2	0	0	0	0	0	2
NONE	OG0013113	1	0	1	0	0	0	2
NONE	OG0013114	1	0	1	0	0	0	2
NONE	OG0013115	1	0	1	0	0	0	2
NONE	OG0013116	2	0	0	0	0	0	2
NONE	OG0013117	2	0	0	0	0	0	2
NONE	OG0013118	1	0	1	0	0	0	2
NONE	OG0013119	2	0	0	0	0	0	2
NONE	OG0013120	2	0	0	0	0	0	2
NONE	OG0013121	2	0	0	0	0	0	2
NONE	OG0013122	1	0	1	0	0	0	2
NONE	OG0013123	2	0	0	0	0	0	2
NONE	OG0013124	2	0	0	0	0	0	2
NONE	OG0013125	1	0	1	0	0	0	2
NONE	OG0013126	1	0	0	0	0	1	2
NONE	OG0013127	2	0	0	0	0	0	2
NONE	OG0013128	1	0	0	0	0	1	2
NONE	OG0013129	2	0	0	0	0	0	2
NONE	OG0013130	2	0	0	0	0	0	2
NONE	OG0013131	1	0	1	0	0	0	2
NONE	OG0013132	1	0	1	0	0	0	2
NONE	OG0013133	2	0	0	0	0	0	2
NONE	OG0013134	1	0	0	1	0	0	2
NONE	OG0013135	2	0	0	0	0	0	2
NONE	OG0013136	1	0	0	1	0	0	2
NONE	OG0013137	1	0	1	0	0	0	2
NONE	OG0013138	1	0	1	0	0	0	2
NONE	OG0013139	2	0	0	0	0	0	2
NONE	OG0013140	2	0	0	0	0	0	2
NONE	OG0013141	1	0	0	1	0	0	2
NONE	OG0013142	2	0	0	0	0	0	2
NONE	OG0013143	1	0	1	0	0	0	2
NONE	OG0013144	1	0	1	0	0	0	2
NONE	OG0013145	1	0	0	1	0	0	2
NONE	OG0013146	1	0	0	1	0	0	2
NONE	OG0013147	1	0	1	0	0	0	2
NONE	OG0013148	1	0	1	0	0	0	2
NONE	OG0013149	1	0	0	1	0	0	2
NONE	OG0013150	1	0	0	1	0	0	2
NONE	OG0013151	2	0	0	0	0	0	2
NONE	OG0013152	1	0	0	1	0	0	2
NONE	OG0013153	2	0	0	0	0	0	2
NONE	OG0013154	2	0	0	0	0	0	2
NONE	OG0013155	1	0	1	0	0	0	2
NONE	OG0013156	1	0	1	0	0	0	2
NONE	OG0013157	1	0	1	0	0	0	2
NONE	OG0013158	1	0	0	1	0	0	2
NONE	OG0013159	2	0	0	0	0	0	2
NONE	OG0013160	2	0	0	0	0	0	2
NONE	OG0013161	2	0	0	0	0	0	2
NONE	OG0013162	1	0	1	0	0	0	2
NONE	OG0013163	2	0	0	0	0	0	2
NONE	OG0013164	1	0	0	1	0	0	2
NONE	OG0013165	1	0	1	0	0	0	2
NONE	OG0013166	1	0	1	0	0	0	2
NONE	OG0013167	1	0	0	1	0	0	2
NONE	OG0013168	1	0	0	1	0	0	2
NONE	OG0013169	1	0	1	0	0	0	2
NONE	OG0013170	1	0	1	0	0	0	2
NONE	OG0013171	1	0	0	1	0	0	2
NONE	OG0013172	2	0	0	0	0	0	2
NONE	OG0013173	2	0	0	0	0	0	2
NONE	OG0013174	1	0	1	0	0	0	2
NONE	OG0013175	2	0	0	0	0	0	2
NONE	OG0013176	2	0	0	0	0	0	2
NONE	OG0013177	2	0	0	0	0	0	2
NONE	OG0013178	1	0	1	0	0	0	2
NONE	OG0013179	1	0	1	0	0	0	2
NONE	OG0013180	2	0	0	0	0	0	2
NONE	OG0013181	1	0	1	0	0	0	2
NONE	OG0013182	1	0	1	0	0	0	2
NONE	OG0013183	1	0	1	0	0	0	2
NONE	OG0013184	1	0	1	0	0	0	2
NONE	OG0013185	1	0	0	0	0	1	2
NONE	OG0013186	1	0	1	0	0	0	2
NONE	OG0013187	2	0	0	0	0	0	2
NONE	OG0013188	2	0	0	0	0	0	2
NONE	OG0013189	1	0	0	0	0	1	2
NONE	OG0013190	1	0	1	0	0	0	2
NONE	OG0013191	1	0	0	1	0	0	2
NONE	OG0013192	1	0	1	0	0	0	2
NONE	OG0013193	2	0	0	0	0	0	2
NONE	OG0013194	2	0	0	0	0	0	2
NONE	OG0013195	2	0	0	0	0	0	2
NONE	OG0013196	1	0	1	0	0	0	2
NONE	OG0013197	2	0	0	0	0	0	2
NONE	OG0013198	1	0	0	1	0	0	2
NONE	OG0013199	1	0	1	0	0	0	2
NONE	OG0013200	1	0	1	0	0	0	2
NONE	OG0013201	1	0	1	0	0	0	2
NONE	OG0013202	1	0	0	1	0	0	2
NONE	OG0013203	1	0	1	0	0	0	2
NONE	OG0013204	2	0	0	0	0	0	2
NONE	OG0013205	1	0	0	0	0	1	2
NONE	OG0013206	1	0	1	0	0	0	2
NONE	OG0013207	1	0	1	0	0	0	2
NONE	OG0013208	1	0	1	0	0	0	2
NONE	OG0013209	2	0	0	0	0	0	2
NONE	OG0013210	2	0	0	0	0	0	2
NONE	OG0013211	1	1	0	0	0	0	2
NONE	OG0013212	1	0	0	0	0	1	2
NONE	OG0013213	2	0	0	0	0	0	2
NONE	OG0013214	1	0	1	0	0	0	2
NONE	OG0013215	2	0	0	0	0	0	2
NONE	OG0013216	1	0	0	1	0	0	2
NONE	OG0013217	1	0	0	0	0	1	2
NONE	OG0013218	2	0	0	0	0	0	2
NONE	OG0013219	1	0	1	0	0	0	2
NONE	OG0013220	1	0	1	0	0	0	2
NONE	OG0013221	1	0	1	0	0	0	2
NONE	OG0013222	1	0	1	0	0	0	2
NONE	OG0013223	1	0	1	0	0	0	2
NONE	OG0013224	1	0	1	0	0	0	2
NONE	OG0013225	2	0	0	0	0	0	2
NONE	OG0013226	2	0	0	0	0	0	2
NONE	OG0013227	1	0	0	0	0	1	2
NONE	OG0013228	1	0	1	0	0	0	2
NONE	OG0013229	1	0	0	1	0	0	2
NONE	OG0013230	1	0	0	0	0	1	2
NONE	OG0013231	1	0	1	0	0	0	2
NONE	OG0013232	1	0	0	1	0	0	2
NONE	OG0013233	1	0	1	0	0	0	2
NONE	OG0013234	1	0	0	0	0	1	2
NONE	OG0013235	1	0	1	0	0	0	2
NONE	OG0013236	1	0	0	0	0	1	2
NONE	OG0013237	1	1	0	0	0	0	2
NONE	OG0013238	1	0	0	0	0	1	2
NONE	OG0013239	2	0	0	0	0	0	2
NONE	OG0013240	1	0	0	1	0	0	2
NONE	OG0013241	1	0	0	0	0	1	2
NONE	OG0013242	1	0	1	0	0	0	2
NONE	OG0013243	2	0	0	0	0	0	2
NONE	OG0013244	1	0	1	0	0	0	2
NONE	OG0013245	1	0	1	0	0	0	2
NONE	OG0013246	1	0	1	0	0	0	2
NONE	OG0013247	1	0	1	0	0	0	2
NONE	OG0013248	1	0	0	1	0	0	2
NONE	OG0013249	1	0	1	0	0	0	2
NONE	OG0013250	1	0	1	0	0	0	2
NONE	OG0013251	1	0	0	1	0	0	2
NONE	OG0013252	1	0	0	0	1	0	2
NONE	OG0013253	1	0	1	0	0	0	2
NONE	OG0013254	1	0	1	0	0	0	2
NONE	OG0013255	1	0	1	0	0	0	2
NONE	OG0013256	1	0	1	0	0	0	2
NONE	OG0013257	1	0	1	0	0	0	2
NONE	OG0013258	1	0	0	1	0	0	2
NONE	OG0013259	2	0	0	0	0	0	2
NONE	OG0013260	1	0	1	0	0	0	2
NONE	OG0013261	1	0	1	0	0	0	2
NONE	OG0013262	1	0	1	0	0	0	2
NONE	OG0013263	2	0	0	0	0	0	2
NONE	OG0013264	1	0	0	1	0	0	2
NONE	OG0013265	1	0	1	0	0	0	2
NONE	OG0013266	1	0	1	0	0	0	2
NONE	OG0013267	1	0	1	0	0	0	2
NONE	OG0013268	1	0	1	0	0	0	2
NONE	OG0013269	1	0	0	1	0	0	2
NONE	OG0013270	1	0	1	0	0	0	2
NONE	OG0013271	2	0	0	0	0	0	2
NONE	OG0013272	1	0	1	0	0	0	2
NONE	OG0013273	2	0	0	0	0	0	2
NONE	OG0013274	1	0	1	0	0	0	2
NONE	OG0013275	1	0	1	0	0	0	2
NONE	OG0013276	1	0	1	0	0	0	2
NONE	OG0013277	1	0	1	0	0	0	2
NONE	OG0013278	1	0	1	0	0	0	2
NONE	OG0013279	1	0	1	0	0	0	2
NONE	OG0013280	1	0	1	0	0	0	2
NONE	OG0013281	2	0	0	0	0	0	2
NONE	OG0013282	1	0	1	0	0	0	2
NONE	OG0013283	1	0	1	0	0	0	2
NONE	OG0013284	1	1	0	0	0	0	2
NONE	OG0013285	1	0	1	0	0	0	2
NONE	OG0013286	1	0	1	0	0	0	2
NONE	OG0013287	1	0	1	0	0	0	2
NONE	OG0013288	1	0	1	0	0	0	2
NONE	OG0013289	2	0	0	0	0	0	2
NONE	OG0013290	1	0	1	0	0	0	2
NONE	OG0013291	1	0	0	0	0	1	2
NONE	OG0013292	1	0	1	0	0	0	2
NONE	OG0013293	1	0	1	0	0	0	2
NONE	OG0013294	1	0	1	0	0	0	2
NONE	OG0013295	1	0	1	0	0	0	2
NONE	OG0013296	1	0	1	0	0	0	2
NONE	OG0013297	2	0	0	0	0	0	2
NONE	OG0013298	1	0	1	0	0	0	2
NONE	OG0013299	1	0	0	0	0	1	2
NONE	OG0013300	1	0	1	0	0	0	2
NONE	OG0013301	1	0	1	0	0	0	2
NONE	OG0013302	1	0	1	0	0	0	2
NONE	OG0013303	1	0	0	0	0	1	2
NONE	OG0013304	1	0	1	0	0	0	2
NONE	OG0013305	1	0	1	0	0	0	2
NONE	OG0013306	1	0	1	0	0	0	2
NONE	OG0013307	2	0	0	0	0	0	2
NONE	OG0013308	1	0	1	0	0	0	2
NONE	OG0013309	1	0	0	1	0	0	2
NONE	OG0013310	1	0	1	0	0	0	2
NONE	OG0013311	1	0	0	0	0	1	2
NONE	OG0013312	1	0	1	0	0	0	2
NONE	OG0013313	1	0	1	0	0	0	2
NONE	OG0013314	1	0	1	0	0	0	2
NONE	OG0013315	1	0	1	0	0	0	2
NONE	OG0013316	2	0	0	0	0	0	2
NONE	OG0013317	1	0	1	0	0	0	2
NONE	OG0013318	1	0	1	0	0	0	2
NONE	OG0013319	1	0	0	0	0	1	2
NONE	OG0013320	1	0	1	0	0	0	2
NONE	OG0013321	1	0	1	0	0	0	2
NONE	OG0013322	1	0	1	0	0	0	2
NONE	OG0013323	2	0	0	0	0	0	2
NONE	OG0013324	1	0	1	0	0	0	2
NONE	OG0013325	1	0	1	0	0	0	2
NONE	OG0013326	1	0	1	0	0	0	2
NONE	OG0013327	1	0	1	0	0	0	2
NONE	OG0013328	1	0	1	0	0	0	2
NONE	OG0013329	1	0	1	0	0	0	2
NONE	OG0013330	1	0	1	0	0	0	2
NONE	OG0013331	1	1	0	0	0	0	2
NONE	OG0013332	1	0	1	0	0	0	2
NONE	OG0013333	1	0	1	0	0	0	2
NONE	OG0013334	1	0	1	0	0	0	2
NONE	OG0013335	2	0	0	0	0	0	2
NONE	OG0013336	1	0	1	0	0	0	2
NONE	OG0013337	1	0	1	0	0	0	2
NONE	OG0013338	2	0	0	0	0	0	2
NONE	OG0013339	0	2	0	0	0	0	2
NONE	OG0013340	0	1	0	1	0	0	2
NONE	OG0013341	0	2	0	0	0	0	2
NONE	OG0013342	0	1	1	0	0	0	2
NONE	OG0013343	0	2	0	0	0	0	2
NONE	OG0013344	0	1	0	1	0	0	2
NONE	OG0013345	0	2	0	0	0	0	2
NONE	OG0013346	0	1	1	0	0	0	2
NONE	OG0013347	0	1	0	0	1	0	2
NONE	OG0013348	0	1	0	0	0	1	2
NONE	OG0013349	0	1	0	1	0	0	2
NONE	OG0013350	0	2	0	0	0	0	2
NONE	OG0013351	0	1	0	0	1	0	2
NONE	OG0013352	0	2	0	0	0	0	2
NONE	OG0013353	0	1	0	0	1	0	2
NONE	OG0013354	0	1	0	1	0	0	2
NONE	OG0013355	0	1	0	1	0	0	2
NONE	OG0013356	0	1	0	0	1	0	2
NONE	OG0013357	0	1	0	0	1	0	2
NONE	OG0013358	0	1	0	0	1	0	2
NONE	OG0013359	0	1	0	0	1	0	2
NONE	OG0013360	0	1	0	1	0	0	2
NONE	OG0013361	0	1	0	0	0	1	2
NONE	OG0013362	0	1	0	0	1	0	2
NONE	OG0013363	0	1	0	0	1	0	2
NONE	OG0013364	0	1	0	0	1	0	2
NONE	OG0013365	0	2	0	0	0	0	2
NONE	OG0013366	0	1	0	1	0	0	2
NONE	OG0013367	0	1	0	0	1	0	2
NONE	OG0013368	0	1	0	0	1	0	2
NONE	OG0013369	0	1	0	0	1	0	2
NONE	OG0013370	0	1	0	1	0	0	2
NONE	OG0013371	0	1	0	1	0	0	2
NONE	OG0013372	0	1	1	0	0	0	2
NONE	OG0013373	0	1	0	1	0	0	2
NONE	OG0013374	0	1	0	0	1	0	2
NONE	OG0013375	0	1	1	0	0	0	2
NONE	OG0013376	0	1	0	0	1	0	2
NONE	OG0013377	0	1	0	0	1	0	2
NONE	OG0013378	0	2	0	0	0	0	2
NONE	OG0013379	0	1	0	0	1	0	2
NONE	OG0013380	0	1	0	0	1	0	2
NONE	OG0013381	0	1	1	0	0	0	2
NONE	OG0013382	0	1	0	1	0	0	2
NONE	OG0013383	0	1	0	1	0	0	2
NONE	OG0013384	0	2	0	0	0	0	2
NONE	OG0013385	0	2	0	0	0	0	2
NONE	OG0013386	0	1	0	0	1	0	2
NONE	OG0013387	0	1	0	0	0	1	2
NONE	OG0013388	0	0	2	0	0	0	2
NONE	OG0013389	0	0	1	1	0	0	2
NONE	OG0013390	0	0	2	0	0	0	2
NONE	OG0013391	0	0	1	1	0	0	2
NONE	OG0013392	0	0	1	1	0	0	2
NONE	OG0013393	0	0	2	0	0	0	2
NONE	OG0013394	0	0	2	0	0	0	2
NONE	OG0013395	0	0	2	0	0	0	2
NONE	OG0013396	0	0	2	0	0	0	2
NONE	OG0013397	0	0	2	0	0	0	2
NONE	OG0013398	0	0	2	0	0	0	2
NONE	OG0013399	0	0	2	0	0	0	2
NONE	OG0013400	0	0	2	0	0	0	2
NONE	OG0013401	0	0	2	0	0	0	2
NONE	OG0013402	0	0	2	0	0	0	2
NONE	OG0013403	0	0	2	0	0	0	2
NONE	OG0013404	0	0	2	0	0	0	2
NONE	OG0013405	0	0	1	0	0	1	2
NONE	OG0013406	0	0	1	0	0	1	2
NONE	OG0013407	0	0	2	0	0	0	2
NONE	OG0013408	0	0	2	0	0	0	2
NONE	OG0013409	0	0	2	0	0	0	2
NONE	OG0013410	0	0	2	0	0	0	2
NONE	OG0013411	0	0	2	0	0	0	2
NONE	OG0013412	0	0	2	0	0	0	2
NONE	OG0013413	0	0	1	1	0	0	2
NONE	OG0013414	0	0	2	0	0	0	2
NONE	OG0013415	0	0	1	1	0	0	2
NONE	OG0013416	0	0	2	0	0	0	2
NONE	OG0013417	0	0	2	0	0	0	2
NONE	OG0013418	0	0	2	0	0	0	2
NONE	OG0013419	0	0	1	1	0	0	2
NONE	OG0013420	0	0	2	0	0	0	2
NONE	OG0013421	0	0	2	0	0	0	2
NONE	OG0013422	0	0	2	0	0	0	2
NONE	OG0013423	0	0	2	0	0	0	2
NONE	OG0013424	0	0	2	0	0	0	2
NONE	OG0013425	0	0	2	0	0	0	2
NONE	OG0013426	0	0	2	0	0	0	2
NONE	OG0013427	0	0	2	0	0	0	2
NONE	OG0013428	0	0	2	0	0	0	2
NONE	OG0013429	0	0	2	0	0	0	2
NONE	OG0013430	0	0	2	0	0	0	2
NONE	OG0013431	0	0	2	0	0	0	2
NONE	OG0013432	0	0	2	0	0	0	2
NONE	OG0013433	0	0	2	0	0	0	2
NONE	OG0013434	0	0	2	0	0	0	2
NONE	OG0013435	0	0	2	0	0	0	2
NONE	OG0013436	0	0	2	0	0	0	2
NONE	OG0013437	0	0	2	0	0	0	2
NONE	OG0013438	0	0	2	0	0	0	2
NONE	OG0013439	0	0	2	0	0	0	2
NONE	OG0013440	0	0	1	1	0	0	2
NONE	OG0013441	0	0	2	0	0	0	2
NONE	OG0013442	0	0	2	0	0	0	2
NONE	OG0013443	0	0	2	0	0	0	2
NONE	OG0013444	0	0	2	0	0	0	2
NONE	OG0013445	0	0	2	0	0	0	2
NONE	OG0013446	0	0	2	0	0	0	2
NONE	OG0013447	0	0	1	0	0	1	2
NONE	OG0013448	0	0	1	0	0	1	2
NONE	OG0013449	0	0	2	0	0	0	2
NONE	OG0013450	0	0	1	0	1	0	2
NONE	OG0013451	0	0	2	0	0	0	2
NONE	OG0013452	0	0	2	0	0	0	2
NONE	OG0013453	0	0	2	0	0	0	2
NONE	OG0013454	0	0	1	1	0	0	2
NONE	OG0013455	0	0	2	0	0	0	2
NONE	OG0013456	0	0	1	0	0	1	2
NONE	OG0013457	0	0	2	0	0	0	2
NONE	OG0013458	0	0	2	0	0	0	2
NONE	OG0013459	0	0	2	0	0	0	2
NONE	OG0013460	0	0	2	0	0	0	2
NONE	OG0013461	0	0	2	0	0	0	2
NONE	OG0013462	0	0	2	0	0	0	2
NONE	OG0013463	0	0	2	0	0	0	2
NONE	OG0013464	0	0	2	0	0	0	2
NONE	OG0013465	0	0	2	0	0	0	2
NONE	OG0013466	0	0	2	0	0	0	2
NONE	OG0013467	0	0	2	0	0	0	2
NONE	OG0013468	0	0	2	0	0	0	2
NONE	OG0013469	0	0	2	0	0	0	2
NONE	OG0013470	0	0	2	0	0	0	2
NONE	OG0013471	0	0	2	0	0	0	2
NONE	OG0013472	0	0	2	0	0	0	2
NONE	OG0013473	0	0	1	1	0	0	2
NONE	OG0013474	0	0	2	0	0	0	2
NONE	OG0013475	0	0	2	0	0	0	2
NONE	OG0013476	0	0	2	0	0	0	2
NONE	OG0013477	0	0	1	0	1	0	2
NONE	OG0013478	0	0	2	0	0	0	2
NONE	OG0013479	0	0	2	0	0	0	2
NONE	OG0013480	0	0	2	0	0	0	2
NONE	OG0013481	0	0	2	0	0	0	2
NONE	OG0013482	0	0	2	0	0	0	2
NONE	OG0013483	0	0	2	0	0	0	2
NONE	OG0013484	0	0	1	1	0	0	2
NONE	OG0013485	0	0	2	0	0	0	2
NONE	OG0013486	0	0	2	0	0	0	2
NONE	OG0013487	0	0	2	0	0	0	2
NONE	OG0013488	0	0	2	0	0	0	2
NONE	OG0013489	0	0	2	0	0	0	2
NONE	OG0013490	0	0	2	0	0	0	2
NONE	OG0013491	0	0	2	0	0	0	2
NONE	OG0013492	0	0	2	0	0	0	2
NONE	OG0013493	0	0	2	0	0	0	2
NONE	OG0013494	0	0	2	0	0	0	2
NONE	OG0013495	0	0	2	0	0	0	2
NONE	OG0013496	0	0	1	0	0	1	2
NONE	OG0013497	0	0	2	0	0	0	2
NONE	OG0013498	0	0	2	0	0	0	2
NONE	OG0013499	0	0	1	1	0	0	2
NONE	OG0013500	0	0	2	0	0	0	2
NONE	OG0013501	0	0	1	1	0	0	2
NONE	OG0013502	0	0	1	0	0	1	2
NONE	OG0013503	0	0	2	0	0	0	2
NONE	OG0013504	0	0	1	1	0	0	2
NONE	OG0013505	0	0	2	0	0	0	2
NONE	OG0013506	0	0	2	0	0	0	2
NONE	OG0013507	0	0	2	0	0	0	2
NONE	OG0013508	0	0	2	0	0	0	2
NONE	OG0013509	0	0	2	0	0	0	2
NONE	OG0013510	0	0	1	0	0	1	2
NONE	OG0013511	0	0	2	0	0	0	2
NONE	OG0013512	0	0	2	0	0	0	2
NONE	OG0013513	0	0	2	0	0	0	2
NONE	OG0013514	0	0	1	1	0	0	2
NONE	OG0013515	0	0	1	0	1	0	2
NONE	OG0013516	0	0	2	0	0	0	2
NONE	OG0013517	0	0	2	0	0	0	2
NONE	OG0013518	0	0	1	0	0	1	2
NONE	OG0013519	0	0	2	0	0	0	2
NONE	OG0013520	0	0	2	0	0	0	2
NONE	OG0013521	0	0	1	1	0	0	2
NONE	OG0013522	0	0	2	0	0	0	2
NONE	OG0013523	0	0	1	0	0	1	2
NONE	OG0013524	0	0	1	1	0	0	2
NONE	OG0013525	0	0	2	0	0	0	2
NONE	OG0013526	0	0	2	0	0	0	2
NONE	OG0013527	0	0	2	0	0	0	2
NONE	OG0013528	0	0	2	0	0	0	2
NONE	OG0013529	0	0	1	0	0	1	2
NONE	OG0013530	0	0	1	1	0	0	2
NONE	OG0013531	0	0	2	0	0	0	2
NONE	OG0013532	0	0	1	0	0	1	2
NONE	OG0013533	0	0	2	0	0	0	2
NONE	OG0013534	0	0	2	0	0	0	2
NONE	OG0013535	0	0	2	0	0	0	2
NONE	OG0013536	0	0	2	0	0	0	2
NONE	OG0013537	0	0	1	0	0	1	2
NONE	OG0013538	0	0	2	0	0	0	2
NONE	OG0013539	0	0	1	1	0	0	2
NONE	OG0013540	0	0	2	0	0	0	2
NONE	OG0013541	0	0	2	0	0	0	2
NONE	OG0013542	0	0	1	1	0	0	2
NONE	OG0013543	0	0	2	0	0	0	2
NONE	OG0013544	0	0	1	0	0	1	2
NONE	OG0013545	0	0	1	1	0	0	2
NONE	OG0013546	0	0	2	0	0	0	2
NONE	OG0013547	0	0	1	1	0	0	2
NONE	OG0013548	0	0	1	0	0	1	2
NONE	OG0013549	0	0	2	0	0	0	2
NONE	OG0013550	0	0	2	0	0	0	2
NONE	OG0013551	0	0	2	0	0	0	2
NONE	OG0013552	0	0	1	0	0	1	2
NONE	OG0013553	0	0	2	0	0	0	2
NONE	OG0013554	0	0	1	1	0	0	2
NONE	OG0013555	0	0	1	0	0	1	2
NONE	OG0013556	0	0	2	0	0	0	2
NONE	OG0013557	0	0	1	1	0	0	2
NONE	OG0013558	0	0	2	0	0	0	2
NONE	OG0013559	0	0	1	0	0	1	2
NONE	OG0013560	0	0	2	0	0	0	2
NONE	OG0013561	0	0	2	0	0	0	2
NONE	OG0013562	0	0	1	0	1	0	2
NONE	OG0013563	0	0	2	0	0	0	2
NONE	OG0013564	0	0	2	0	0	0	2
NONE	OG0013565	0	0	1	0	0	1	2
NONE	OG0013566	0	0	1	0	0	1	2
NONE	OG0013567	0	0	2	0	0	0	2
NONE	OG0013568	0	0	2	0	0	0	2
NONE	OG0013569	0	0	1	0	0	1	2
NONE	OG0013570	0	0	1	1	0	0	2
NONE	OG0013571	0	0	2	0	0	0	2
NONE	OG0013572	0	0	1	1	0	0	2
NONE	OG0013573	0	0	1	1	0	0	2
NONE	OG0013574	0	0	2	0	0	0	2
NONE	OG0013575	0	0	2	0	0	0	2
NONE	OG0013576	0	0	1	0	0	1	2
NONE	OG0013577	0	0	1	0	0	1	2
NONE	OG0013578	0	0	1	1	0	0	2
NONE	OG0013579	0	0	2	0	0	0	2
NONE	OG0013580	0	0	2	0	0	0	2
NONE	OG0013581	0	0	2	0	0	0	2
NONE	OG0013582	0	0	2	0	0	0	2
NONE	OG0013583	0	0	1	0	0	1	2
NONE	OG0013584	0	0	2	0	0	0	2
NONE	OG0013585	0	0	2	0	0	0	2
NONE	OG0013586	0	0	2	0	0	0	2
NONE	OG0013587	0	0	1	0	0	1	2
NONE	OG0013588	0	0	2	0	0	0	2
NONE	OG0013589	0	0	2	0	0	0	2
NONE	OG0013590	0	0	1	1	0	0	2
NONE	OG0013591	0	0	1	0	1	0	2
NONE	OG0013592	0	0	2	0	0	0	2
NONE	OG0013593	0	0	1	1	0	0	2
NONE	OG0013594	0	0	2	0	0	0	2
NONE	OG0013595	0	0	0	2	0	0	2
NONE	OG0013596	0	0	0	2	0	0	2
NONE	OG0013597	0	0	0	1	0	1	2
NONE	OG0013598	0	0	0	2	0	0	2
NONE	OG0013599	0	0	0	2	0	0	2
NONE	OG0013600	0	0	0	2	0	0	2
NONE	OG0013601	0	0	0	2	0	0	2
NONE	OG0013602	0	0	0	2	0	0	2
NONE	OG0013603	0	0	0	2	0	0	2
NONE	OG0013604	0	0	0	2	0	0	2
NONE	OG0013605	0	0	0	2	0	0	2
NONE	OG0013606	0	0	0	2	0	0	2
NONE	OG0013607	0	0	0	2	0	0	2
NONE	OG0013608	0	0	0	2	0	0	2
NONE	OG0013609	0	0	0	2	0	0	2
NONE	OG0013610	0	0	0	2	0	0	2
NONE	OG0013611	0	0	0	2	0	0	2
NONE	OG0013612	0	0	0	1	0	1	2
NONE	OG0013613	0	0	0	2	0	0	2
NONE	OG0013614	0	0	0	2	0	0	2
NONE	OG0013615	0	0	0	2	0	0	2
NONE	OG0013616	0	0	0	2	0	0	2
NONE	OG0013617	0	0	0	2	0	0	2
NONE	OG0013618	0	0	0	2	0	0	2
NONE	OG0013619	0	0	0	2	0	0	2
NONE	OG0013620	0	0	0	2	0	0	2
NONE	OG0013621	0	0	0	2	0	0	2
NONE	OG0013622	0	0	0	2	0	0	2
NONE	OG0013623	0	0	0	2	0	0	2
NONE	OG0013624	0	0	0	2	0	0	2
NONE	OG0013625	0	0	0	2	0	0	2
NONE	OG0013626	0	0	0	2	0	0	2
NONE	OG0013627	0	0	0	1	1	0	2
NONE	OG0013628	0	0	0	2	0	0	2
NONE	OG0013629	0	0	0	2	0	0	2
NONE	OG0013630	0	0	0	2	0	0	2
NONE	OG0013631	0	0	0	2	0	0	2
NONE	OG0013632	0	0	0	2	0	0	2
NONE	OG0013633	0	0	0	2	0	0	2
NONE	OG0013634	0	0	0	2	0	0	2
NONE	OG0013635	0	0	0	2	0	0	2
NONE	OG0013636	0	0	0	2	0	0	2
NONE	OG0013637	0	0	0	2	0	0	2
NONE	OG0013638	0	0	0	2	0	0	2
NONE	OG0013639	0	0	0	1	0	1	2
NONE	OG0013640	0	0	0	2	0	0	2
NONE	OG0013641	0	0	0	2	0	0	2
NONE	OG0013642	0	0	0	2	0	0	2
NONE	OG0013643	0	0	0	2	0	0	2
NONE	OG0013644	0	0	0	2	0	0	2
NONE	OG0013645	0	0	0	2	0	0	2
NONE	OG0013646	0	0	0	1	1	0	2
NONE	OG0013647	0	0	0	2	0	0	2
NONE	OG0013648	0	0	0	2	0	0	2
NONE	OG0013649	0	0	0	2	0	0	2
NONE	OG0013650	0	0	0	2	0	0	2
NONE	OG0013651	0	0	0	1	0	1	2
NONE	OG0013652	0	0	0	2	0	0	2
NONE	OG0013653	0	0	0	2	0	0	2
NONE	OG0013654	0	0	0	2	0	0	2
NONE	OG0013655	0	0	0	2	0	0	2
NONE	OG0013656	0	0	0	1	1	0	2
NONE	OG0013657	0	0	0	1	0	1	2
NONE	OG0013658	0	0	0	2	0	0	2
NONE	OG0013659	0	0	0	2	0	0	2
NONE	OG0013660	0	0	0	2	0	0	2
NONE	OG0013661	0	0	0	2	0	0	2
NONE	OG0013662	0	0	0	2	0	0	2
NONE	OG0013663	0	0	0	2	0	0	2
NONE	OG0013664	0	0	0	2	0	0	2
NONE	OG0013665	0	0	0	1	0	1	2
NONE	OG0013666	0	0	0	1	0	1	2
NONE	OG0013667	0	0	0	1	0	1	2
NONE	OG0013668	0	0	0	1	1	0	2
NONE	OG0013669	0	0	0	1	0	1	2
NONE	OG0013670	0	0	0	2	0	0	2
NONE	OG0013671	0	0	0	2	0	0	2
NONE	OG0013672	0	0	0	2	0	0	2
NONE	OG0013673	0	0	0	2	0	0	2
NONE	OG0013674	0	0	0	2	0	0	2
NONE	OG0013675	0	0	0	2	0	0	2
NONE	OG0013676	0	0	0	2	0	0	2
NONE	OG0013677	0	0	0	2	0	0	2
NONE	OG0013678	0	0	0	2	0	0	2
NONE	OG0013679	0	0	0	2	0	0	2
NONE	OG0013680	0	0	0	2	0	0	2
NONE	OG0013681	0	0	0	1	0	1	2
NONE	OG0013682	0	0	0	2	0	0	2
NONE	OG0013683	0	0	0	2	0	0	2
NONE	OG0013684	0	0	0	2	0	0	2
NONE	OG0013685	0	0	0	1	0	1	2
NONE	OG0013686	0	0	0	2	0	0	2
NONE	OG0013687	0	0	0	1	1	0	2
NONE	OG0013688	0	0	0	2	0	0	2
NONE	OG0013689	0	0	0	2	0	0	2
NONE	OG0013690	0	0	0	2	0	0	2
NONE	OG0013691	0	0	0	1	0	1	2
NONE	OG0013692	0	0	0	1	1	0	2
NONE	OG0013693	0	0	0	1	0	1	2
NONE	OG0013694	0	0	0	2	0	0	2
NONE	OG0013695	0	0	0	2	0	0	2
NONE	OG0013696	0	0	0	2	0	0	2
NONE	OG0013697	0	0	0	2	0	0	2
NONE	OG0013698	0	0	0	1	0	1	2
NONE	OG0013699	0	0	0	1	0	1	2
NONE	OG0013700	0	0	0	1	0	1	2
NONE	OG0013701	0	0	0	2	0	0	2
NONE	OG0013702	0	0	0	2	0	0	2
NONE	OG0013703	0	0	0	2	0	0	2
NONE	OG0013704	0	0	0	1	0	1	2
NONE	OG0013705	0	0	0	1	1	0	2
NONE	OG0013706	0	0	0	2	0	0	2
NONE	OG0013707	0	0	0	1	0	1	2
NONE	OG0013708	0	0	0	2	0	0	2
NONE	OG0013709	0	0	0	2	0	0	2
NONE	OG0013710	0	0	0	2	0	0	2
NONE	OG0013711	0	0	0	2	0	0	2
NONE	OG0013712	0	0	0	1	1	0	2
NONE	OG0013713	0	0	0	2	0	0	2
NONE	OG0013714	0	0	0	2	0	0	2
NONE	OG0013715	0	0	0	2	0	0	2
NONE	OG0013716	0	0	0	1	0	1	2
NONE	OG0013717	0	0	0	2	0	0	2
NONE	OG0013718	0	0	0	2	0	0	2
NONE	OG0013719	0	0	0	1	0	1	2
NONE	OG0013720	0	0	0	2	0	0	2
NONE	OG0013721	0	0	0	2	0	0	2
NONE	OG0013722	0	0	0	2	0	0	2
NONE	OG0013723	0	0	0	1	0	1	2
NONE	OG0013724	0	0	0	1	0	1	2
NONE	OG0013725	0	0	0	2	0	0	2
NONE	OG0013726	0	0	0	2	0	0	2
NONE	OG0013727	0	0	0	2	0	0	2
NONE	OG0013728	0	0	0	2	0	0	2
NONE	OG0013729	0	0	0	1	0	1	2
NONE	OG0013730	0	0	0	1	0	1	2
NONE	OG0013731	0	0	0	2	0	0	2
NONE	OG0013732	0	0	0	1	0	1	2
NONE	OG0013733	0	0	0	1	0	1	2
NONE	OG0013734	0	0	0	1	0	1	2
NONE	OG0013735	0	0	0	2	0	0	2
NONE	OG0013736	0	0	0	2	0	0	2
NONE	OG0013737	0	0	0	1	0	1	2
NONE	OG0013738	0	0	0	2	0	0	2
NONE	OG0013739	0	0	0	1	0	1	2
NONE	OG0013740	0	0	0	1	0	1	2
NONE	OG0013741	0	0	0	2	0	0	2
NONE	OG0013742	0	0	0	2	0	0	2
NONE	OG0013743	0	0	0	2	0	0	2
NONE	OG0013744	0	0	0	2	0	0	2
NONE	OG0013745	0	0	0	1	0	1	2
NONE	OG0013746	0	0	0	1	0	1	2
NONE	OG0013747	0	0	0	2	0	0	2
NONE	OG0013748	0	0	0	2	0	0	2
NONE	OG0013749	0	0	0	2	0	0	2
NONE	OG0013750	0	0	0	2	0	0	2
NONE	OG0013751	0	0	0	2	0	0	2
NONE	OG0013752	0	0	0	1	0	1	2
NONE	OG0013753	0	0	0	2	0	0	2
NONE	OG0013754	0	0	0	1	0	1	2
NONE	OG0013755	0	0	0	1	1	0	2
NONE	OG0013756	0	0	0	1	1	0	2
NONE	OG0013757	0	0	0	2	0	0	2
NONE	OG0013758	0	0	0	2	0	0	2
NONE	OG0013759	0	0	0	2	0	0	2
NONE	OG0013760	0	0	0	1	1	0	2
NONE	OG0013761	0	0	0	1	0	1	2
NONE	OG0013762	0	0	0	2	0	0	2
NONE	OG0013763	0	0	0	2	0	0	2
NONE	OG0013764	0	0	0	1	0	1	2
NONE	OG0013765	0	0	0	2	0	0	2
NONE	OG0013766	0	0	0	2	0	0	2
NONE	OG0013767	0	0	0	2	0	0	2
NONE	OG0013768	0	0	0	2	0	0	2
NONE	OG0013769	0	0	0	2	0	0	2
NONE	OG0013770	0	0	0	2	0	0	2
NONE	OG0013771	0	0	0	2	0	0	2
NONE	OG0013772	0	0	0	2	0	0	2
NONE	OG0013773	0	0	0	1	0	1	2
NONE	OG0013774	0	0	0	2	0	0	2
NONE	OG0013775	0	0	0	2	0	0	2
NONE	OG0013776	0	0	0	2	0	0	2
NONE	OG0013777	0	0	0	2	0	0	2
NONE	OG0013778	0	0	0	1	0	1	2
NONE	OG0013779	0	0	0	1	0	1	2
NONE	OG0013780	0	0	0	1	0	1	2
NONE	OG0013781	0	0	0	2	0	0	2
NONE	OG0013782	0	0	0	1	0	1	2
NONE	OG0013783	0	0	0	2	0	0	2
NONE	OG0013784	0	0	0	2	0	0	2
NONE	OG0013785	0	0	0	2	0	0	2
NONE	OG0013786	0	0	0	2	0	0	2
NONE	OG0013787	0	0	0	2	0	0	2
NONE	OG0013788	0	0	0	1	1	0	2
NONE	OG0013789	0	0	0	2	0	0	2
NONE	OG0013790	0	0	0	1	1	0	2
NONE	OG0013791	0	0	0	1	0	1	2
NONE	OG0013792	0	0	0	1	0	1	2
NONE	OG0013793	0	0	0	1	0	1	2
NONE	OG0013794	0	0	0	2	0	0	2
NONE	OG0013795	0	0	0	2	0	0	2
NONE	OG0013796	0	0	0	2	0	0	2
NONE	OG0013797	0	0	0	2	0	0	2
NONE	OG0013798	0	0	0	1	0	1	2
NONE	OG0013799	0	0	0	1	0	1	2
NONE	OG0013800	0	0	0	2	0	0	2
NONE	OG0013801	0	0	0	2	0	0	2
NONE	OG0013802	0	0	0	2	0	0	2
NONE	OG0013803	0	0	0	0	2	0	2
NONE	OG0013804	0	0	0	0	2	0	2
NONE	OG0013805	0	0	0	0	2	0	2
NONE	OG0013806	0	0	0	0	2	0	2
NONE	OG0013807	0	0	0	0	2	0	2
NONE	OG0013808	0	0	0	0	2	0	2
NONE	OG0013809	0	0	0	0	2	0	2
NONE	OG0013810	0	0	0	0	2	0	2
NONE	OG0013811	0	0	0	0	2	0	2
NONE	OG0013812	0	0	0	0	2	0	2
NONE	OG0013813	0	0	0	0	2	0	2
NONE	OG0013814	0	0	0	0	2	0	2
NONE	OG0013815	0	0	0	0	2	0	2
NONE	OG0013816	0	0	0	0	2	0	2
NONE	OG0013817	0	0	0	0	2	0	2
NONE	OG0013818	0	0	0	0	2	0	2
NONE	OG0013819	0	0	0	0	2	0	2
NONE	OG0013820	0	0	0	0	2	0	2
NONE	OG0013821	0	0	0	0	2	0	2
NONE	OG0013822	0	0	0	0	2	0	2
NONE	OG0013823	0	0	0	0	2	0	2
NONE	OG0013824	0	0	0	0	2	0	2
NONE	OG0013825	0	0	0	0	2	0	2
NONE	OG0013826	0	0	0	0	2	0	2
NONE	OG0013827	0	0	0	0	2	0	2
NONE	OG0013828	0	0	0	0	2	0	2
NONE	OG0013829	0	0	0	0	2	0	2
NONE	OG0013830	0	0	0	0	2	0	2
NONE	OG0013831	0	0	0	0	2	0	2
NONE	OG0013832	0	0	0	0	2	0	2
NONE	OG0013833	0	0	0	0	2	0	2
NONE	OG0013834	0	0	0	0	2	0	2
NONE	OG0013835	0	0	0	0	2	0	2
NONE	OG0013836	0	0	0	0	2	0	2
NONE	OG0013837	0	0	0	0	2	0	2
NONE	OG0013838	0	0	0	0	2	0	2
NONE	OG0013839	0	0	0	0	2	0	2
NONE	OG0013840	0	0	0	0	2	0	2
NONE	OG0013841	0	0	0	0	2	0	2
NONE	OG0013842	0	0	0	0	2	0	2
NONE	OG0013843	0	0	0	0	2	0	2
NONE	OG0013844	0	0	0	0	2	0	2
NONE	OG0013845	0	0	0	0	2	0	2
NONE	OG0013846	0	0	0	0	2	0	2
NONE	OG0013847	0	0	0	0	2	0	2
NONE	OG0013848	0	0	0	0	2	0	2
NONE	OG0013849	0	0	0	0	2	0	2
NONE	OG0013850	0	0	0	0	2	0	2
NONE	OG0013851	0	0	0	0	2	0	2
NONE	OG0013852	0	0	0	0	2	0	2
NONE	OG0013853	0	0	0	0	2	0	2
NONE	OG0013854	0	0	0	0	2	0	2
NONE	OG0013855	0	0	0	0	2	0	2
NONE	OG0013856	0	0	0	0	2	0	2
NONE	OG0013857	0	0	0	0	2	0	2
NONE	OG0013858	0	0	0	0	2	0	2
NONE	OG0013859	0	0	0	0	2	0	2
NONE	OG0013860	0	0	0	0	2	0	2
NONE	OG0013861	0	0	0	0	2	0	2
NONE	OG0013862	0	0	0	0	2	0	2
NONE	OG0013863	0	0	0	0	2	0	2
NONE	OG0013864	0	0	0	0	2	0	2
NONE	OG0013865	0	0	0	0	2	0	2
NONE	OG0013866	0	0	0	0	2	0	2
NONE	OG0013867	0	0	0	0	2	0	2
NONE	OG0013868	0	0	0	0	2	0	2
NONE	OG0013869	0	0	0	0	2	0	2
NONE	OG0013870	0	0	0	0	2	0	2
NONE	OG0013871	0	0	0	0	2	0	2
NONE	OG0013872	0	0	0	0	2	0	2
NONE	OG0013873	0	0	0	0	2	0	2
NONE	OG0013874	0	0	0	0	1	1	2
NONE	OG0013875	0	0	0	0	2	0	2
NONE	OG0013876	0	0	0	0	2	0	2
NONE	OG0013877	0	0	0	0	2	0	2
NONE	OG0013878	0	0	0	0	2	0	2
NONE	OG0013879	0	0	0	0	2	0	2
NONE	OG0013880	0	0	0	0	2	0	2
NONE	OG0013881	0	0	0	0	2	0	2
NONE	OG0013882	0	0	0	0	2	0	2
NONE	OG0013883	0	0	0	0	2	0	2
NONE	OG0013884	0	0	0	0	2	0	2
NONE	OG0013885	0	0	0	0	2	0	2
NONE	OG0013886	0	0	0	0	2	0	2
NONE	OG0013887	0	0	0	0	2	0	2
NONE	OG0013888	0	0	0	0	2	0	2
NONE	OG0013889	0	0	0	0	2	0	2
NONE	OG0013890	0	0	0	0	1	1	2
NONE	OG0013891	0	0	0	0	2	0	2
NONE	OG0013892	0	0	0	0	2	0	2
NONE	OG0013893	0	0	0	0	2	0	2
NONE	OG0013894	0	0	0	0	2	0	2
NONE	OG0013895	0	0	0	0	2	0	2
NONE	OG0013896	0	0	0	0	2	0	2
NONE	OG0013897	0	0	0	0	0	2	2
NONE	OG0013898	0	0	0	0	0	2	2
NONE	OG0013899	0	0	0	0	0	2	2
NONE	OG0013900	0	0	0	0	0	2	2
NONE	OG0013901	0	0	0	0	0	2	2
NONE	OG0013902	0	0	0	0	0	2	2
NONE	OG0013903	0	0	0	0	0	2	2
NONE	OG0013904	0	0	0	0	0	2	2
NONE	OG0013905	0	0	0	0	0	2	2
NONE	OG0013906	0	0	0	0	0	2	2
NONE	OG0013907	0	0	0	0	0	2	2
NONE	OG0013908	0	0	0	0	0	2	2
NONE	OG0013909	0	0	0	0	0	2	2
NONE	OG0013910	0	0	0	0	0	2	2
NONE	OG0013911	0	0	0	0	0	2	2
NONE	OG0013912	0	0	0	0	0	2	2
NONE	OG0013913	0	0	0	0	0	2	2
NONE	OG0013914	0	0	0	0	0	2	2
NONE	OG0013915	0	0	0	0	0	2	2
NONE	OG0013916	0	0	0	0	0	2	2
NONE	OG0013917	0	0	0	0	0	2	2
NONE	OG0013918	0	0	0	0	0	2	2
NONE	OG0013919	0	0	0	0	0	2	2
NONE	OG0013920	0	0	0	0	0	2	2
NONE	OG0013921	0	0	0	0	0	2	2
NONE	OG0013922	0	0	0	0	0	2	2
NONE	OG0013923	0	0	0	0	0	2	2
NONE	OG0013924	0	0	0	0	0	2	2
NONE	OG0013925	0	0	0	0	0	2	2
NONE	OG0013926	0	0	0	0	0	2	2
NONE	OG0013927	0	0	0	0	0	2	2
NONE	OG0013928	0	0	0	0	0	2	2
NONE	OG0013929	0	0	0	0	0	2	2
NONE	OG0013930	0	0	0	0	0	2	2
NONE	OG0013931	0	0	0	0	0	2	2
NONE	OG0013932	0	0	0	0	0	2	2
NONE	OG0013933	0	0	0	0	0	2	2
NONE	OG0013934	0	0	0	0	0	2	2
NONE	OG0013935	0	0	0	0	0	2	2
NONE	OG0013936	0	0	0	0	0	2	2
NONE	OG0013937	0	0	0	0	0	2	2
NONE	OG0013938	0	0	0	0	0	2	2
NONE	OG0013939	0	0	0	0	0	2	2
NONE	OG0013940	0	0	0	0	0	2	2
NONE	OG0013941	0	0	0	0	0	2	2
NONE	OG0013942	0	0	0	0	0	2	2
NONE	OG0013943	0	0	0	0	0	2	2
NONE	OG0013944	0	0	0	0	0	2	2
NONE	OG0013945	0	0	0	0	0	2	2
NONE	OG0013946	0	0	0	0	0	2	2
NONE	OG0013947	0	0	0	0	0	2	2
NONE	OG0013948	0	0	0	0	0	2	2
NONE	OG0013949	0	0	0	0	0	2	2
NONE	OG0013950	0	0	0	0	0	2	2
NONE	OG0013951	0	0	0	0	0	2	2
NONE	OG0013952	0	0	0	0	0	2	2
NONE	OG0013953	0	0	0	0	0	2	2
NONE	OG0013954	0	0	0	0	0	2	2
NONE	OG0013955	0	0	0	0	0	2	2
NONE	OG0013956	0	0	0	0	0	2	2
NONE	OG0013957	0	0	0	0	0	2	2
NONE	OG0013958	0	0	0	0	0	2	2
NONE	OG0013959	0	0	0	0	0	2	2
NONE	OG0013960	0	0	0	0	0	2	2
